19
  -1   33   51   49   82   51   10   89   54   86   91   95    1   54   53   39   29   47   68 
  86   -1   21   13   19   62   15   30   62   55    5   97   35   37   83   86   86   65   90 
  48    7   -1   44   87   98   91   88    4   97   27   34   44   47   72   18   12   91   80 
  28   22   42   -1   35   27   91   70   16   74    9    2   92   99   50   51   95   89    1 
  86   77    5   83   -1   56   39   80    3   63   98   68   55   78   48   29   20   83    8 
  63   53   24   90   14   -1   78   82   65   80   85   60   70   86   47   47   91   82    4 
  83   62   59   46   60   27   -1    1   38   27   82   10   10   90   74   16   14   16   30 
  44   98   48   25   35    8   95   -1   21    7   42   12   90   98   95   52   58   42   13 
  37   95    3   65   30   14   27   20   -1   88   43   87    4   26   31   54   74   56   89 
  34   51   62   42   46   74   84   44   22   -1   36    2   16    1   92   63    5    9   93 
  19   36   14   59   80   53   15   58   84   21   -1   32   93   62   18   96   24   12   42 
  50   96   87   24   85   41   40   38   85    4   43   -1   94   49   14   31   15   25   63 
  68   92   21    5   13    5   98   27   75   46    3   88   -1   89   54   84   28   78   21 
  69   71   60    7   27   55    1   76   70   84   92   47   99   -1   60   40   20   17    5 
  77   15   33   53   14   36   93    3   42   29   31   73   51   52   -1   44   63   11   23 
  18   13   99   40   49   91   88   49    4   28   21   21   85   51   89   -1   18   56    3 
   7   49   58    1   78   41   74   81   45   70   44   57   93   63   70   45   -1   55   71 
  36   43   20   92   23   94   66    9   45    7   79    1   62   38   50   20   40   -1   80 
  13   14   14   58   85   58   15   30   73   37   75   29    9   64   24   81    8    0   -1 
