25
  -1   41   78   83   17   63   13   78   70   21   30   16   30   36    0   74   75   99   84   66   13   94    3   48   39 
  15   -1   14   28    9   74   70   34   16    0   18   33   64   83   63   86   56   45    3   86   82   55   60   57   54 
  96   75   -1   19   91   79   68   30   46   34   10   56    8   80   42   76   32   12   61   96   95   76   35   51   22 
  38   89   56   -1   93    2   65    0   98   40   19   89   19   39   71   18   73   81   74   34   13   16   10   46   29 
  24   94   76    0   -1   29   80   74   19   69   30   13   71   95   65   22   88   84   63    7   76   35   77   49   68 
  51   35   34   20   98   -1   32   49   22   26   77   74    8   57   49   27   27   79   92   50   27   57   72   15   94 
  36   74   70   23   52   71   -1   43   55    7   77   75    5    9   24   79   88    2   53   48   11   54   27   90   34 
  20   41   13   29   65   80   23   -1   53   54   45   76   58   17   72   14   24   49   89   81   11   66   12   51   20 
  65   51   31   20   78   22    6   50   -1   15   71   32   80   51   55   34    5    1   62   64   70   34   78   46   36 
  19   27   99   85   39    2    5   56   53   -1   37   28   83   11   86   86   26   57   18   58    8   25   92   66   78 
   7   82   48   93   12   94   81   31   73   32   -1   69   64   34   74   73   39   63   53   75   74   40   61    0   49 
  31   59   10   56    3   76   87   62   58   35    8   -1   22   82   89   53    7   22   22   72    8   49   97    0   12 
  50   75   39   90   88   91   92   19    2    2   27    6   -1   30   14   20   40    2   28   62   84   70   67   43   44 
  42   15   52   91   12    4   55   15   31   94   57   19   38   -1   49   90   40   51   70   98   33   36   19   73   38 
  99   35   74   69    3   18   13   45   85   18   88   50   22   95   -1   65   54   42   22   25   80   72   68   20   75 
  38   19    9   74   38   82   65   89   70   39   59   25    9   24   22   -1   95   42   62   97   17   57   62   23   99 
  84   48   79    8   16    0   36    6   71   97   81   61   31   46   50    1   -1   37    9   26   47   34    0   94   28 
  62   91   45   20   53   20   19   89   69   51   50   37    3   38   44   74   35   -1   77   35   66   23   85   20   60 
  47   98   59   81   99    5   61   61   96   59   33    1   79    5   43    0   56   45   -1   38   11   83   34   85   18 
  11   72   36   34   57   56   46    4    7   58   37    6   63   51   19   12   10    5   13   -1   89   10    8   42   18 
  53   80   81   36   66   18    6   77   90   95   63   47   51   61    4   10   19   93   68   35   -1   44   40   47    6 
  45   12   48    7   21   90   77   74   22   58   11   88   76   69   65   66   64   80   65   68   41   -1   21   78   13 
  67   47   48   63   39   47   70   84   59   18   43   80   60   20   55   82   30   18   22    6   39   87   -1   24    4 
  19   41   24   60   15   54   73   34   53   73   97   92   20   67   76   80   37   19   60   97   91   67   31   -1   21 
  85   53   79   25   92   55   81   11   49    5   72   64   59   97   98   13   71   47    5   91   15   34   71    4   -1 
