35
  -1   38   23   28   68   29   54   31   58   74   64   39   30   85   11   92   17   91   88   86   49   77   37   92   22   82   88   16   50   91   12   53   81   35   81 
  49   -1   17   35   32   75   62   96   66   44   81   77   36   50   20   25   36   69   54   25   13   76   60    1   44   62   44   56   67   25   44   49   26   61   36 
  58   88   -1   50    6    6   94   39   35   31   42   56    8   30   25   62   56   91   90   68   44   35   30   89   43   97   66   39   98   93   52   87    3   40   89 
  62   98   84   -1   53   34   15   95   90   75   26   67   37   34   58   27    2   55   14   84   44   58   33   62   97   84    7    2   23   63   42   12   25   93   96 
  30   27   63   26   -1   17   38    4   84   27   90   95    7   92   50   21   28   46   31   13    8   81   97   16   83   72   79   77   85   56   70   33   86   97   49 
  64   66   39   68   51   -1   67   58   46   74    2   48   47   82   94   31   96    2   12   45   70   47   70   49   24   55    5   47   40   44   44   89    8   11   29 
  29   14   48   39   60   74   -1   94   60   21   76   54   52   24   56   16   22   27   63   92   28   40   99   86   87   39   30   31   81   90   94   10   19    8   58 
  59   20   32   53   80    5   81   -1   86   10    6   43   78   28   22   94   72    2   34   71   88   21   10   70    4   91   61   51   53   80   11   63   91   32   47 
  96   64    5   78   51   15   84   46   -1   45   64   20   39   36   22   73    7   11   46   69   81    3   13   94    6   66   75   17   82   18    1   29   15   18   34 
  93   69    1   29   67   99   93   87   38   -1   81    9   64   40   72   62    9    6   65   74    0   71   93   75   89   75   46   42   56   61   60   43   54   81   96 
  35   48   95   28   87   34   61   49   98    1   -1   21   60   62   27   78   89   28    1   82   55   42    9    1   85   65   62   45   60   68   27   57    3   27   52 
  83   15   38   44   64   88   97   37    1   12   65   -1   31    1   45   32   83    0   75   92    2   12    9   16   57   70   85   36   79   40   16   83   24   83   22 
  20   99   62   18   36   63   82   53   94   83   98   79   -1   18   99   54   62   53   18   71   21   27   93   58   16   24   99   32    8   75   67   82   95   66   44 
  65   54   60   47    8    6   82   58   85    0   57   91   62   -1   62    9   86   84   37   79   94   53    4   93   37   64   20    4   98   68   22   42   33   76   54 
  33   36   13   67   95   50   68    4   42   30   19    3   16   55   -1   92   48   49   97    4   95   34   20   15   90   18   83   12   12   69   41   67   54   77   32 
  21   24   82   41   29   76   24    0   80   40   55   24   40    4   22   -1   96   99    8   16   67   51   34   50   63   47   71   56   66   25   86   98   99   10   80 
  40   91   57   64   43   89   57   98   65   49    3   87   46   54   48   62   -1   21   99   97   24   14   96   95   71   62   73    9   60   72   71   92   64   63    1 
  81    6   42   38   57    8   87   12   47   33   66   95   48   40   46   45   64   -1   61   41   11   84    3   36   93   15   60   64   59   25   79   61    6   38    3 
  96   95   63   35    7   11   21   25   58   69   17   57   14   33   18    7   45   54   -1   62   81   99   29   94   15   88   19   95   49   77   85    5   25   32   20 
  60   91   83   81   16   94   50   86   51   16   19   21   23   64   75   37   98   26   66   -1   92   41   55   63   36   56   92   73   13   17    5   34   77   96   69 
  59   65   63   61   51   14   78   70   35   53   87   62   91   37   88   57   81   82   12   44   -1   18   21   36   44   34   53   49   20   82   98   90   93   15    5 
  55   66   20   33   88    7   38   27   22   29   64   62   87   45   44   51   89   15   72   77   59   -1   59   82   60   31   65   58   73   58   73   79   65   91   99 
  50   80   58   89    7   80   18   24   43   57   69   87    9   11   54   33   40   13   44   23   74   76   -1   40   84   49   98   10   28   64    1   79   14   33   38 
  55   93   70   74   17   65   31   38   53   92   49   59   26   42   73   22   65   99   98    5   35    0   55   -1   45   80   71   47   60   38   32   50   93   25   20 
  67   94   86   51   33   91   43   34   50   21   76   75   44   41   26   94   98   62   94   54    7   75   25    6   -1   87   63   39   37   57   16    9   76   11   47 
  27   44   90   23   78   93   44   55   20   40   48   47   35   47    9   81    1   68   56   78   27   95   42   66   84   -1   51   34   94   27   45   93    7   41   84 
  82   20   29   78   27   49   19   27   48    6   74   57   87   27   78   44    6    5   91    0   23   76   51   57   70   30   -1    3   15   89   44   51   23   16   80 
   2   95   82   73   23   30   79   97   88   66   77   18   62   83   23   54   35   46   30   86   55   52   68   58   67   10   55   -1   19   33   23   51   35   19   33 
   8   42   64   39   91    4    6   68   22   68   51   97   74   86   95    4   24   50   56   45   61   76   55   16   47   88   91   98   -1   76   10   32   36   52   96 
  76   44    0   82   12   74    2   16   71   77   54   66   33   31   16   42   76   77   18   31   45   17   71   37   15   99   99   47   36   -1   52   95   12   48   47 
  46   12   21   48   28   44   77   35   10   63   66   79    5   94    8   75   77    6   92   48   95   59   48   94    7   36   98   54   48   46   -1    2   94   11   75 
  94   39   20   24   26   82   87   44   13   44   38   74   71   15   80   63   16   27   22   16   21   81   52   72   36   52   18   90   98   29   17   -1   44   21   37 
  68   99   72    7   44   37   51   34   11   22    2   43   37   18   70   12   86   44   45   90   68   33   94   38   23   92   68   41   88   41   30   57   -1   92   54 
  64   36   92   68   23   55   42   25   51   80   43   73   44   81   17   89   71   37   23   17   76   46    9   44   39   97   37   22    6   81   76   23   18   -1   20 
  43   41   76   85   66   27   17   61    0   61   94   70   51   65    7   74   34   83   72   43   79   64   92   68   86   51   50   62   74   20   35   69   13   11   -1 
