29
  -1   37   16   99    3   38    0   40   36   96   11   98   77   86   12   60   27   78   66   38   74   36   92   49    2   97    6   54   70 
  73   -1   27   57   10   43    8   13   33    8    5   69   57   17   20   34   55   32   47   82   62   13   21   37   49   65   38    4   14 
  44   10   -1   84   17   38   93   27   33    2   93   19   10   50   88   67   67   60   54   75   45    1   57   59   66   30   48   67   48 
  86   23   62   -1   30   34   99   99   72   92   79   57   94   72   76   57   22   17   76   42   77   30   17   74   83   26   34   49    9 
  82   17   57   69   -1   40   71   51   74   70   51   98   63   30    8    9   54   84   18   28    1   47   70   31   77   39    5   61   66 
  91   62   27   74   79   -1   84   95   72   55   46   98   78   97   97   93   79   57   54   33   41   73   62   95   20   84   78   49   76 
  35   62   94   27   25   21   -1   53   56   57   48   28   64   46   27   42   44   76   35   75   33   90    9   26   15   23   73   87   59 
  51   36   35   39   51   81   66   -1   76    2   71   84   59   71   13   24   17   40   18   13   68   54   89    1   96   50   27   11   25 
  53   98   36    4   86   24   95   37   -1    5   13   65    8   84   50   19   55   15   95   73   55   14   38   75   20   79   76   16   29 
  55   27    6    8   25   43   65   11   67   -1   60    1   72   74   66   32   10   68   52   66   83   99   91   90   13   29   65   33   61 
  41   49   90   49   28   97   57   53   92   74   -1   17   59   35   18   83   61   36   16   71    5   20   89   88   19   80   79   33   62 
  96   18   23   90   20   65   39   48   14   48    2   -1    6   23   71   17   10   89    1   23   25   17   46   82   37   36   71   56   68 
   2   41   82   50   12   57   40   32   75   31   80   89   -1   80   34   48   55   57   65   17   46   66   92   24   35   38    6   72   26 
  29   81   95   83   74   77   34   86   87   26   70   62   58   -1    3   51   90   37   99   45   47   17   14   93   83    6   69   19   96 
  28   43   23    9   76   18   93   51   47   79   89   86    5   60   -1   48   63   63   52   53   52    3   50   99   20   16   45   56   22 
  66   27   71   94   22   94   56   99   64   49   50   63   80   39   50   -1   37   51   98    1   14   50    6   19    6    9   18   26   25 
  15   34    0   82   61   71   28   84   17   84   83   81   85   85   96   65   -1   76   46    3   28   97   56   94   99   14   13    5   75 
  84   84    1   99   18   53   81   80   76   62   16   93   46   51   26   32   88   -1   22   49   64   21   52   44   18   60   39   17   75 
   4   75   50   88   59    3   40   77    8   73    9   84   35   25   29   82   28    7   -1   66   16   82   15   81    3   68   77   73   80 
  16   90   55   73   65   58   61   76   13    1   54   22   27   63   58   62   41   40   96   -1   21   99   62   38   81   78   71   36   98 
  48    9   78   17    0   86   90   17   44    3   94    9   57    0   83   84   63   94   98   56   -1   34   95   78   85   57   68   67   87 
  39    3   85   39   13   64    8   65    2   98   34   46   54   28   55   11   28   91   47   44   85   -1   45   52   19   40   82    4   98 
  50   23   37   41   79   23   33   92   39   41    9   41   92   43   39   98   24   46    9    4   37   56   -1    0   22   53    5   93   94 
  87   50   44   90   73   81   83   52   56   68   96   95   62   57   88   54   53   27    4   77   74   13   33   -1   63   21   86   86   74 
  91   79   20   30   29   64   20   55   98   56    7   54   24   56    2   86   13   90   92   66   18   96   95   44   -1   61   29    7   34 
  67   45   61   58   25   81   88    6   98   61   61   96   17   21   50   41   77   52   80   42   95   24    9   13   73   -1   56    9   34 
  37   68   21    4   14   82   62   39   63    3   97   61   64   59   57   81   80   60   74   57   64    6   99   59   31   60   -1   24    4 
  69   33   90    6   54   11   11   68   93   25   59    9   28   56   70   92   15   80   25   47   92    0   56    8    6    8   68   -1   89 
  68   44   45   37   30   36   96   84   99    7   52   45   84   11   54   13   19   76   57   87    8   83   34    0   35   91    9   41   -1 
