9
  -1   52   55   96   74   66   57   63   49 
  88   -1   96   50   22   71   83   15   29 
  53   66   -1   51   89   98   74   86    2 
  59   66   29   -1   37   77   11   23   81 
  66   71   56   32   -1   80   71   82   68 
  19   84   43   42   67   -1   58   71   20 
  76   75   61   75    1   47   -1   77   60 
  65    6   98   42   17   21   24   -1   36 
  93   32   68   73   55    2   94   74   -1 
