31
  -1   18   92    3   37   10   74   24   96   87   29    6    7   78   42   24   91   59   93   86   97   49   54   32   74   83   46   34    0   16   46 
  73   -1   34   38   77   24    0   51   48   97   38   29   55   98   60   50   22   51    9   67   37   58   16   43   91   90   26   37   77   26   53 
  75    0   -1   39   65   29   15   66   80   63   63   70   45   70   20    5   20   43   56   29   62   93   40   79   88   31   21   14   20   98   92 
  25   25   92   -1   16   91   21   32   57   53   47   72   76   92   42   96   97   63   91   53   44   54   98   36   85   86   67    6   52   39   57 
  45   64   82   89   -1   81   25   63   13   82   68   60   54   44   53   97   41   50   12   32   56    8   38   54   45   23   93   64   82   45    4 
  91   42   68   25   32   -1    1   51   47   14   33   15   27   88   60   80   37   53   82    1   85   90    9   76   97    6   99   42   71   33   39 
  27   24   82   47   50   66   -1   49    1   13   15   34   28   42   74   40   74   11   93    9   64   31   99   74    7   48   32   58   90   55   92 
  30   82   68   64   82   18   30   -1   31   71   95   98   58   75   41   32   16   67   96   61   76   60   92   28   86   51   28   71   62   19   26 
   6    1   61   74   65   43   45   47   -1   26   16   42   24   74   17   17   59   85   37   55   47   13   67   91   93   54   95   74   77    9   45 
   3   15   46   16   41   63   59   38   10   -1   37    7   52   14   33   21   31   92   59   68   99    6   34   67   49   79   73   96   53   50    5 
  98    5   72   96   22   66   59   33    4   69   -1   71   11   73   85   97   95   68   89   54   89   89   12   23    8   13   54   33   62   60   35 
  19   10   40   92    7   62   10   18   96   66   88   -1   19   30   61    4   27    8   24   16   14   13   57   26   36   65   92   43   50   54    3 
  85   73   13   26   17   72   40   79   91   88   46   31   -1    7   76   44   63   55   53   88   71   19    1   81   98   90   98   90   33   49   96 
  36   34   21    1   12   39   74   53   70   17   41   16   48   -1    1   44   92   64   99   97   52   23   17   54    4   15   96    2   57   29   51 
  53   65   38   74   18   50   65   92   55   36   61   49    4    9   -1   50    1    2   14    0   51   19   23   68   25   79   83   21   82   40   50 
  85   45   67   23   20   85   26   37   30   81   73   91   30   30   53   -1   32   31    7   47   83   58   18   59   27   43   38   62   64   72   55 
  14   58    0   33   33   72   18   11   10    0   45   35   44   27   17   97   -1   60   48    4   59   32   14   77   43   41   20   81   56   84    6 
  11   50   16   63   83   49   88   53   13   98    6   58   85    2   37    3   99   -1   97    3   55   56   35   69   33   30   63    5   12   71   41 
  18   34   91   34   97   26   35   37   32    0   35   90   10   73   92   48   76   43   -1   45   79   50   54   67   71   39   97   86   45   61   57 
  86   31   91   30   17   41    8    5   78   92    5   66   34   16   39   78   64   67   73   -1   61   98   23   15   65   47    7   15   85   52   28 
  43   90   60   86   72   77   79   33   82   10   77   40   76   12   56   67   90   72   86   16   -1   33   84   39    1    2   38    8   17   24   12 
  45   19    2   57   57   27   87   37   60   69   47   37   61   75    1   17   94   44   89   80   60   -1   75   64   51   76   66   90   84   35   66 
  96   33   85   50   90   42   77   77   31   89   99   30   79   60    5   80   30   51   24   71   31   84   -1   46   48   88   22   14   78   58    2 
  96    6   35   81    9   25   75   38   55   59   28    6   89   59   18   47   39   48   98   16   20   30   52   -1   66   78   40   41   44   70   51 
  46   66   58   33   99   19   11   27   57   66   86   37   24   75   96   42   74   88   43   73   56   63   55   60   -1   81   85   53   22   81   23 
  26   28   42   84   61   41   55   24   68   12   90   54    2   66   82   98    9   56   38   52   81   46   67   36    7   -1   48   73   60   23   55 
  83   49   35   77   85   48   19   40   73   39    4   15   46    6   82   28    5   91   36   95   95   70   42   14    6    1   -1   62   32   61   37 
  87   96   38   22   74   23   70   93   15   43   84   20   11   30   26   93   10   83   36   47   79   83   17   73   97   75   74   -1   11   59   35 
  49   46   83   87   20   57   63   43    2   78   38   87   98   49   69   25   42   80    8   78   79   39   61   48   64   58   75   38   -1   70   35 
  25   71   81    9   58    2   18   73   45   21   52   83   60    2   33   29   27   27    9   88    6   88   79   19   36   44   78   12   34   -1    0 
  47   60   23   80   21   33   34   39    7   31   60   59   67   20   61   52    2   41   79   11   81   37   52   60   57   40   56   87   52   91   -1 
