16
  -1   98   65   77   21   41   27   99   62   86   28   18   67   41   40   29 
  41   -1    4   45   19   63   58   35   63   98    9   90   84   89   21   89 
  27   20   -1   55    4   41   48   84   92   62   70   72   32   37   65   73 
  66    6   29   -1   63   77   44   73   12    7   72   22   50   56   63   71 
  46   90   43   53   -1   47   36   53   31   28   15    1   52   48   90   18 
  73    8   24    2   72   -1    2   47   45   14    6   17   88   56   26   51 
  28   24   94   23   77   41   -1   60   30   24   88   97   77   93   45   19 
  11   18   27   87   73   51   41   -1   20   97    8   78   66   96   35   44 
   0   15   68   94   38   45   87   98   -1   27   63   39   25   92   84   22 
  11   95   41   38   34   14   42   76   86   -1   39   84   16   57   32   51 
  54   32   18   22   78    9   20   65    7   47   -1   80   98   24   72   82 
  47   83   29   88   74   64   54   16   40   92    7   -1   76    8   16    8 
  12   70   93   82   93   71   91   13   89   51   12   69   -1   49   37   42 
  84   84   77   65   24    3   29   78   71   21   22   78   49   -1   82   47 
  58   94   17   51   77   62   74   20   27   63   71   40   33   73   -1   29 
  27   57   13   56   74   37   12    4   67   83   77   89   14   27   71   -1 
