17
  -1   61   37   18   30   40   47   45   14   67   72   78   39   64   63   12   93 
  42   -1   21    6   50   95   95   62   51   62   46   81    3   12    8   75   73 
  97   93   -1   55   37   40    0   51    7   25   81   98   89   96   10   35   90 
  83   93   41   -1   31   89   55   82    3   53   63    7   65   23   82   90   20 
  27   46   57   19   -1   46   61   78   23   94   77   13   43   39    0   33   75 
  93   26    6   34   82   -1   88   38   35    4   97   53   27   31   43    0   58 
  89    9   29   88   22    7   -1   11   17   36   76   60   28   28   45    3   22 
  72    9    8    6   49   98   93   -1   53   95   46   33   26   90   33   84   31 
  94   65   71   17   73   83   86   61   -1   11   98   89   40   43   92   14   67 
   1   22   73    3   21   19    8   68   65   -1   41   95    7   26   31   91   21 
  97   62   90   22   97   76   83    9   26   73   -1    1   69   17   67   89   71 
  41   14   74   62   33   82   83   99   24   78   58   -1    2   61   49   75   58 
  12   65   80    9   93   16   70   19   41   71   41   58   -1   38   82   29   80 
  96    3   94   30   86   29   81   62    7   39   16   69   89   -1   92   79   53 
   9   12   62    3   28   85   74   69   56   67   27   47   49    9   -1   79   46 
  12   25   28   50   55    9   12   14   48   29   83   89   73   15   94   -1   82 
  27    9   37    7   94   64   28    2   31    7   49   33   16   80   31   81   -1 
