20
  -1   75   74   61   20   81   92   73   95   31   75   15   71   56   80   85   70   39   22   80 
  54   -1    5    6   92   80   87   53   96   63   34    5   63   10   79   76   82   13   69   56 
   8    0   -1   31   76   71   39   56   56   61   47   31   42    2   36    0   46   68   87   51 
  65   50   85   -1   70   66   47    1   42   82   66   11   38   75   11   21    3   82   61   11 
  91   22   59   74   -1   16   13   62   16   11   30   55   62   47   58   99   17   24   99   71 
  66   81   37   30   71   -1   64   93   92   67   76    5   31   19   28   42   93   96   55   55 
  65   18   37   20   80   85   -1   78   31   54    2   30   25   21   63   63    3   34   27   96 
  79   47   24   84   78   43   64   -1   72   88   61   27   95   26   97   33   46   29   70   77 
  60   24   31   43   50   52   58   65   -1    7   93   44    4   24   43   28    8   73   24   73 
  45   64   86   24   60   12   21   45   10   -1   50   15   87   11   91   19    6   93   23   64 
  58   31    9   55   87   33   98   15   42   72   -1   91   67   17   56   53   42   16   17   63 
  13   27   14   80   15   77   71   86   83   17    9   -1   99   27   92    9   82   79   42   81 
  47   36    5   90   55   22   46    8   16   14   25   80   -1   27    5   46   59   72   75   83 
  58   10    0   19    9   27   64   18   62   95   61   95   42   -1   49    0   85    5   74   31 
  65   91   46   43   23   25   48   21   85   20   96   68   78    6   -1   20   49   15   99   13 
  86   61    9   47   56    3   48   56   88   53   31   20   19   22   18   -1   62   97   43   62 
  18   80   82   14    0   12   72   72   61   87   72   27   73   33   36   72   -1   90   39   21 
  98   80   26   29    0   45    3   70   59    0   65   21   70   46   55   84   98   -1   67   56 
  71   81   96   43    8   21   28   96   94   18   35   67   69   67   45   98   19   91   -1   54 
  89    2    6   55   76   77   53   31   13   51   51   70   74   84   18   69   92   39   98   -1 
