10
  -1   86   89   17    5   47   88   78   24   15 
  39   -1   51   17   87   28   77    4   86   75 
  47   56   -1   49   23   92   94    7   12   19 
  62   15   13   -1   88   53    2    5   59    2 
  46   37   78   13   -1   28   29   30   15    9 
   8   72   95   35   71   -1    3   36   94   95 
  30   53   60   50   67   75   -1   15   55   80 
  70   13   91   72   11   80    2   -1   24    9 
  31    7   76   92   15   48   39    2   -1   19 
  43   91   65   90   73   70   50   23   37   -1 
