21
  -1   88   85   68   75   52   37   95   98   88   14   41   42    4   95    0   11   71   77   64   55 
  91   -1   67    6   13   94   42   31   63   34   22   61   74    8   30    1   12   19   96   10    7 
  11    3   -1   49   67   51    2   78   22   31   94   29   22   61   87   87    7   29   70   71   15 
  93   84   41   -1   53   66   43   65   86   91   28   93   54   31   95   21   34   97   51    9   28 
  45   38    3   59   -1   26   42   66    7   65   37   23   10   74   64   63   40   59   28   26   51 
  56   72   57   40   19   -1   79   74   16   82   83   96   28   74   51   39   52   94    5   59   11 
  95   82   21   69   99   84   -1    9   58   12   88   61   21   12   19   61   31   98   35   99   32 
  71   95   60   45   99   99   97   -1   45   57    8   56   52   91   77   21   42   61   82    0   25 
  22   14   46   34   33    7   17   83   -1   95   16   15   18   64   76   15   63   27   64   60   84 
  72   16   88   15   45   61   57    6   44   -1   10   83   18   24   30    5   57   89   22   40   36 
  39    7    6   55   35   73   70   63   37   30   -1   99   10   46   88   77   91   49   35   49   45 
  97   84   64   21   66   69   30    8   43   22   96   -1   34   29    3   89   65   76   59   28   66 
  41   79   28   87   19    5   30   69   92   31   66   89   -1   16   30   10   34   51   92   42   47 
  14   39   81   44   94   23    9   70   34   89   88   76   68   -1   16   15   40   22   98    9   14 
  29   27    4   97   10   66   32   61   59   74   60   25   65   42   -1   69   59   65   30   82   99 
  19   70   27   40   87   43   80    9   41   41   75   22   68   31   20   -1   78   98    4   92    9 
  30   52   34   96   46   56   55   63   86   37   15   58    8   42   50   95   -1   37   82   56   78 
  23   83   53   43   15   25   74   13   29   18   74   59   70   60   55   69   16   -1   11   32   55 
   0   47   65   60   90   15    7   79   49   63   58   72   47   11   67   62   36   41   -1   27   17 
  59   53   76   82   13   84   51   82   47   35   89   47   83   54    8   25   21   15    4   -1   70 
  31   14   94   30   77   61   44   65   55   23   82   66   76   11    0   89   47    3   23   94   -1 
