30
  -1   51   29   83   71   73   28    9    3   64   57   87   16   16   91   61    0    2   15   65   74   91   23   61    0    6   95   52   41   38 
  13   -1   34   89   94   17   13   68   98   74   23   62   31   11   78   47    2   91   47   57    6   13   31   50   88   44    2   94   91    6 
  87   30   -1   20   73   71   14   43   36   34   41   10   58   55   41   21   86   88   75   77   88   84   84    1   67   86   89   11   88   35 
   3   94   74   -1   85   66   99    8   81   42   45   67   83   55   25   91   97   46   77   37   74    6   25   58   90   78   26   28   67   37 
  16   54   40   63   -1   80   77   29   80   86   62   22   83   30   58   38   55   49   87   54   78   25   28   84   50   86   27   29   12   55 
  48    2   24   55   94   -1   87   35   72   16   15   10   79   90   93    9   48   83   16   49   71   70   79   48   98   15   98   37   94   79 
  49   50   80    3   26   35   -1   98   13   22   70   81   38   32   12   80   77   73   28   60   90   29   31   12   60   31   11   75   30    0 
  70   61    1   72   41    5   50   -1   28    3   63   51   25   96   41    9    9   21   86   34    1   46   24   82   30   37   42   61    0   69 
  43   52   39   57   53   63   50   58   -1   13   79   13   28   82   38   77   23   47   38   96   85   72   97   32   49   31   14   86   73   75 
  38   42   71   90   34   28   95   49   78   -1   54   15   57   19   43   91   10   20   66    9   58   62   95   83   11   27   32   42   41   70 
  67   68    8   62   39   50   96   67   97   97   -1   46    3   12   55   23    8   99   33   28   65   42   39   28   37   22   91   16   54   34 
   9   24   53   78   84   15   69   86   11   37   83   -1   61   35   87   73   42   62   81   41   95   62   59   89   53   87   27   27   30   95 
  33   64    5    9   70   35   93   85    4   31   49   93   -1   66   10   80   53   35   75   67   69   16   62   83   75   52   36   14   31   15 
  45   26   48   61   83   57   31   18    2   69   75   33   18   -1   68   99   28   49    5   63   76   72   84   92   87   67   20   91    3   86 
  22   70   83    0   18   97   84   75   80   54   29   49   29   62   -1   67   98   14   47   99   71   63   75   95   47   19   34   15   91   25 
  70   30   99   41   13    0   59   62   36   87   43   90   16   92   20   -1   31   12   70   97   59   21   68   22   48   15   70   19   50   37 
  63   75    7   45   75   48   10   75   60   73   63   99   68   53   15   60   -1   25   98   24   47   95   84   20   15   58   20   31   80   92 
  81   17   55    8   77   52   83   25   62   10   37   35   73   36    3   79    4   -1   16   56    2   40    4   50   76   76   65   87   97   48 
  67   41   29   37   48   90   14    0   73   39   62   36   29   98   61   65   53   92   -1   21   21   49   76   62    5   26   90   33   43   77 
  82   92   97   23   73   34   71   63   48   71   89   39   34   77   20   84   38   86   89   -1   83   59   11   32   35   25   89   61   15   22 
   5   45    5   49   94   28   22   28    0   86   28   23   75   19    9    4   40   93   42   78   -1   83   77   37   46    9   73   71   50   86 
  38   73   43   83   30   92   29   10   15   57   62   53   37   86   80   57   95   84   49   41   78   -1   27   24   56   16   70   65   89   93 
  68   28   31   41   71   67   23   64   96   33   31    6   96   84   43   82   64   52   77   48    1   70   -1   26   80   94   82   97   16    0 
  38    9   68   66   93   61   38   60   84   54   56   17   37   62   65   21   58   47   85   10   77   85   64   -1   47   11   44   94   46   41 
  62   98   80   24   66   98   17   79   88   77   63   42   85   32   31    0   98   52   58   97   89   20   74   74   -1   84   74   38   81   68 
  36   74   30   34   54   54   52    5   23   31   93    0   46   88   38   78   19   38   28   72   48   26   13   68   52   -1   40    5   26   78 
  38   46   66   12   29    0   19   35   52   24   59   35   17   11   81    5   49   11   77   39   40    1   87   18   14    8   -1   22   54   13 
   1   84   51   47   50   15   76    2   34   64   54   10   23   89   28   86   22   85   88   34   62   27   74   63   15   44   30   -1   75   66 
  84   88   67   69   91   67   71    6   95   74   93   59   80    3   34   22   83   21   44   21    9   78   83   88    4   99   55    0   -1   81 
  30   67   65   70   86   86   61   53   10   20   49   84   65   60   64   68   95   38    4   68   83   25   77   13   60   65   18   11   73   -1 
