12
  -1    6   75   90   41   67   90   54   14   60   87   44 
  43   -1   58   74   58   76   22   81   15   64   95   86 
  49   64   -1   35   27   97   30   54   75   57   60   51 
  48   54   70   -1   38   60   36   98    0   80   94   58 
  54    4   35   28   -1   85    2   44   32   41   93   96 
  76   72   93   59   27   -1   21   16   39   72   64   45 
  94   54    6   30    5    6   -1   10   51   64   16   55 
  51   96   92    6   40   24   47   -1   85   72   75   57 
  18   34   36   39    3   28   63   19   -1   73   57   74 
  31   39   31   89   49   82    6   17   37   -1   57   13 
  81   15    5    5   14   90   29   90   99   47   -1   76 
  88   86   79   16   49   99   41    6   25   73   45   -1 
