26
  -1    5   84    2   97   51   33   18   37   39   50   14   31    5   95   43   54   52   67   70   63   64   20   76   35   68 
  34   -1   79   35   68   50   39   73   86   93   22   38   79   41   27   18   91   41    1   48   88   44    3   40   63   25 
   3   80   -1   46   32   15   66   18   46    1   38   49   92   11   35   86   86   73   17   27    0   35   70   93   36   70 
  81   33   25   -1   73   48   51   29   28   49   61   96   15   79   42   68   17   91   12   80   79   98   66   52   67   45 
   5    2   67   98   -1   91   38   80   76   63   53   76   66   34    5   15   95    1   82   26   95    2   95   87   15   28 
  66   65   46   70   33   -1   44   75   87   63   74   30    1    6    6   17   11   83   83   46   40   51   93   41   85   20 
  36   88   67   75    3   47   -1   93   68   46   16   53   90   91   41   53   17   71    7   23   30   76   35   65   11   81 
   5   62   26   98   48   46   34   -1   88   66   62   91   13    7   11   11   23   17    1   67   58    7   36   81   66   60 
  11   42   47   76    5   80   81   68   -1    6   79   68    5   66    8   23   80   51   88   39   14    0   15   31   53   82 
  89   60   70   23   26   30   34   20   29   -1   63   26   61   44   46   20   76   66   25   94   74    0   74   25   88   13 
  39   88   28   23   42   62   64   54   33   87   -1   33   15   22   53   97   85   31   58   81   29   30    9   95    7    3 
  21    7   29   46   96   95   38   36   23   13   30   -1   38   77   85   23   65   18   90   39   23   87   76    7   98    9 
  36   28   19   32   36   22   53   43   52   52   91   47   -1   42   28   22   55   10   12   84   95   35   49   65   78   40 
  41   65   16   48   15   26   84   44   45   68   32   19   22   -1   27   23   26   19   22   20   99   97   27    9    9   11 
  57   97   13   22   75   53   63   92   22   11    8   48   48    4   -1   45   16   36   16   38   63   92   16   82   14   36 
  33   11   63   43   73   27    0   22   40   74   97   93   38   41   67   -1    1   49   67   49   53   64   66   41   81   56 
   5   73   73   39   39   61   73    3   77   68   76    4   20   98   96   94   -1   47   41   84   88    9   38   90   76   87 
  95   41    5   37   74   62   42   99   87   33   90    0   58   93   77   26   69   -1   33   98   19   29   45   18   71   81 
  59   32   19   49    8   59   96    1   64   33   27   78   27   26   17   61   17   18   -1   19   10   47   46   32   33   96 
   3   62   41   74   85   23   33   17   42   34   78   53   30   31   18   64   59   48   91   -1   85   66   52   54   36   24 
  17   83   22    1   16   18    4   31   60   30   68   35   63   38   29   97   68   83   28   99   -1    1   44   58    1   35 
  96   67   40   50    3   64   19   39   86   20    7   56   77   90   68    7   11    3   23   49   33   -1   20   17   16    0 
  16   69   44   27   70   32   23   90   24   25   93   40   97   84   78   17   44   34   46   34    3    6   -1   97   58   29 
  46   91    1   15   59    2   84   80   98   11   51   30   86   41    6   63   86   46   60   23   24   30   67   -1   59   76 
  53   14   34   51   72   63   49   16   65   65   75   19   49   56   17   60   59    0   98   52    6   61   38   53   -1   22 
  13   29    4   32   40   80   38   54   15   89   79   30   90   47   47   55   22   66   56   30   36   16   41   36   66   -1 
