11
  -1   77   91   45   10   61   10    1   85   73   82 
  87   -1   49   43   70   56   71   62   23   20   53 
  26   91   -1   96   69   57   87   42   79   89   18 
  17   67    9   -1   14   77   22   76   30   59   49 
  64   46   98    7   -1   68   55   79   82   78   51 
  35   56   94   32   25   -1    3   71   68   83   60 
  86    0   79   47   66    8   -1   21   42   39   80 
  43    3   78   41   63   46   48   -1   94   28   79 
  97   15   35   91   47   13   95   70   -1   81   78 
  83   19   30   62   18   48   23   39   90   -1   62 
  19   85   17   97   26   32   95   27   26   75   -1 
