32
  -1   39   51   51   62   84   72   95   18   11    2    2   24   13   69   96   75   21   98   68    0   62   49   90   14   61   47   54   18   34   59   61 
  73   -1   62   12   35   46   36   82   17   99   85   19   23   98   88   72   25   61   70   93   13   32   94    3   98    8   50   53   26   36   64   87 
  61   26   -1   51   48   73   39   31   90   38   16   61   14   66   49   38   92   10    8   85   23   93   32   79   91   40   29   96   18   18   60   57 
  79   87   60   -1   28   12   99   11   54   89   27   15    3   93   16   41   37   78    2   75    1   47    7   80   90   99   62   87   17   32   99   74 
  11   38   34   91   -1   50   85    2   56   74   81   71   30   27   39   23   64   17   77   91   71   24   98   51   15   97   65   54   66   97    5   40 
  61   44   26    4   46   -1   11   59   55   38   40   26   68   19   18   43   36   35   21   27    6   45   78   10   12   75   75   18   42   25   24   34 
  38   20   13   42   18   76   -1    1   73   14   94   52   34   13   70   78    1    5   99   29   12   96   59   22   61   34   49   79   28   26   55   15 
  64   75   28    7   94   56   60   -1   67   71   54   71   57   68   41   87   21   47   38    2   11   35   61   85   96   48   34   27   28   13   83   43 
  77   58   23   36    4   80   97   24   -1    3   51   95   12   71   37    0   93   36   38   47   99   25    9   84   21   57   18    1   85   83   84   81 
  61   94   56   49   51   36   46   75   91   -1   50   22    4   21   11    4   66   47   94   14   46   20   75   82   93   32   53   94   69   36   30    2 
  97   25   59   47   76   47   45    3   39   95   -1   25   95   69   37   51   35   36   45    1   35   17   76   17   11   60   70    5   82    7   36   84 
  56   13   95    3   89   43    1   44   34   96   69   -1   29   65   58   32   53   95   29    6   82   47   83   99   58   43   22   15   77   29   51   62 
  85   16   57   41   57   52   42    1   86   90   23   67   -1    8   81   51   13   28   81   19   10   28    2   10   38   98   32   53   75   13   57   89 
  98   73   99   91   31   51   85   84   90   28    7   57   88   -1   89    9    1   17   42   20   28   70   75   90    8   25   22   13   52   87   70   42 
  85   96   41   29   27   44   66   63   34   94   71   44   82   60   -1    5   35   29   47   56   57   69   83   99   77    8   73   42   60   60   13   54 
  98    9   47   27   88   44   93   51   78   40   22   74   74   34   79   -1   10   16   26   66   73   95    1   25   24   61   98   67   73   59   32   28 
  57   93   27   36   81   71   81   84    2   21   59   76   96   45   56   58   -1   61   34   76   87   82   77   12   58   38   10   25   11   21    9   91 
  78    2   19   14   35   42   96   72   44   69   83   21   17   28   77   75   42   -1   63   51   29   45   28   93    4   18    3   81   82   77   91   73 
  55   45   44   22   33   87   18    5   83   39   40    4   57   68   33   32   10   49   -1   36   91   94   64   84   50   35   40   32   17   17   75   90 
  24   72   87   46    5   26   16   62    9   56    2   66   65   23   51   49   85    0   85   -1   77   47   50   61   97   85   53   29   54   70   56   44 
  95   29   83   93   86    9   10   49   71   66    3   89   83   26   40   32   64   93   18   41   -1   40   20   54   37   57    8   67   11   78   75    7 
  25    4   91   19   91   52   29   92   23   47   47   12   82   26    5   14   90   98   32   31   38   -1   52   85   75   61   45   94   72   76   70   80 
   1   26   23   72   69   75   53   61   51   52   61   15   34   87   72   49   77   70   33   60   60   38   -1   97   88   99   43   82   24   19    4   56 
  72   31   79   97    0    6   50   14    9   55   75   77   89   14   49   90   91   20   76    3   32   66   52   -1   20   65   95   55   41   66   59   97 
  91   42   28   88   95   87   38   61   48   93   36   25   35   50   75   77   93   47   53   48   79   19    0    0   -1   37   48    7   30   14   18   80 
   5   61   60   93    8   47   84   69   96   29   57   73   16   59   48   94    4   95   99   52   75   19   52   27    8   -1   52   34   38   67    4   18 
  24   17   79   70   25   78    6   46   26   35    3    0    4   62    0   98   66   96   97   70   23   68   75    2   76   27   -1   88   67   94   92   37 
  71   10   68   41   35   47   47   34   25   34   37   77   38   52   78   88   70   74   86   41   49    6   68   51   35   95   91   -1    2   42   83   91 
  13   93   60    6   81   59   53   15   84   39    4   62   78   56   92   66   79   18    4   72   67   63   40   70   98   35   61   52   -1   77   44   43 
  42   90   55   48   23   14   53   90   51   93   94   13   23    3   57   41   82   75   98    6   42   61   46   64   11   33   25   15   11   -1   21   58 
   5   63   66    6   86   80   59   28   31    4   23   96   79   78   53   73   60   28   71   18   22   84   64   38   95   97   63   10   60   37   -1   20 
  66   52   38   24   91   19   83   19    2   40   42   51   71   20   56   44   32   37   15   50   11   51   66   50   98   64   65   60   76    2   81   -1 
