15
  -1   83    3   93   12   43   34    9    0   61   60   95   86   28   26 
  44   -1   42   27   89    7   74   65   44   27   81   93   36   48   90 
  36    8   -1   21   71   11   15   83    6    1   44    7   63   56   54 
  49   36   80   -1   45   78   60   34   37   34   99   34   13   80   27 
  49   80   17   37   -1   89   90    8   52   57   43   59   59   40   18 
  22   96   72   23   33   -1    4   20   63   16   54    1   50   53   35 
  63   85   14   64   66   83   -1    1    7   25    9   59   83   53   70 
  42   45   40   16   41   64   91   -1   26   69   11   42   85   17   43 
  88   70   30    3    7   96   68   25   -1   31   21   32   56   31   44 
  39   36   14   33   81    7    1   74   71   -1   92    1   92   55   43 
  30   72   38   18   94   20   21    2   68   41   -1   27   99   63   12 
   7   46   56   99   82   22   32   15   29   34   41   -1   53   78   94 
  45   86   89   75   58   79   45    5   99   19    7   19   -1   60   86 
  70   23   50   78   21    6   29   55   81   61   70   62   47   -1   64 
  15   78   58   61   64   48   88   74   27   34   79   79    5   38   -1 
