22
  -1   39   12   93   74   18   53   51   39   21    7    9    4   22   55   34   51   17   30   17   24   53 
  51   -1   42   29   14   95   18   61   98   94   55   89    6    1   15   25   54   66   64   27   74   26 
  31   48   -1   81   17   99   50   47   16   26    0   20   69   29   34   16    0   96   14   94    3   56 
  52   56   71   -1   77   63   38   94   90   64   72   74   12    5   91   11    8   39   80   34   39   52 
  55   21   86   71   -1   21   34   38   67   90   94   19   46   17   49   61   55   43   52   71   67   26 
  83   72   69   47   80   -1    8   27   67    0   79   22   21   17   46   94    4   84   61   94   30   80 
  92   47   29   54    3   24   -1   58   26   43   36   10   68    5   57   48   66   36   67   66   67   90 
  39   84   36   33   88   72   94   -1   34    2   26   27   49    8   33    4   84   43   31   28   31   41 
  96   36   50   96   54   38   64   72   -1    5    6   11   41   42   44   82   14   90   68   68   17   47 
  17   77   80   22   61   75   53   41    6   -1   46   89   95   48   86   49   86    2   22   43    8   33 
  84    2   30   18   68   20   87   36   89   34   -1   53   18   67   27   80   42   80   73   49   78   63 
  44   26    1   45   12   55   67   55   15    1   92   -1   69   83   62   37   55   49   25   45   36   30 
  63    3   58   95   97   90   21   46   69   36   42   95   -1   89   88   60   44    7   15   11   60   59 
  80   43   74   17   99   23   94   96   11   24   11   66   34   -1    7   64   25   80   62   94   16   57 
  41    5   45    1    1   52   69   12   13   28   92    8    2   61   -1    7   78    7    3   41   31   15 
   8   66   74   72   43    6   86   89   74   43   30   31   40   32   32   -1   93   53   96   58   33   40 
  18   88   53   26   66   60   81   59   43   48   67   61   74   91    4   80   -1   78   93   54   21   76 
  37   62   60   69    7   13   17   17   46   57   35   34   62   13   52   22   95   -1   12   18   95   79 
  79   70   23   36    2    1   81    9   22   57   46   36   17   68   95   30   85   12   -1   29   95   48 
  63   57   61   68   32    8   80   50    4   11   29   26   34   17   80   87   99   41   62   -1   56   40 
  98   26    8   94   56   45   58   37   92    6   53   50   20   21   34   80   53   84   84   64   -1   65 
  62   51   83   95   90   34   36   52   90   76    3   16   36   49   25   34    7   62   26   66   15   -1 
