12
  -1   56   29   84   46   52   64   85   95   84   54   24 
  90   -1   80   62   25   44   69   24   58   23   13   28 
  28   70   -1   20   20   41   64   19   68   87   27   50 
  71   26    2   -1   88   11   98   24   18   74   14   50 
  36   40   94   57   -1   64    4   81   29   84    9   99 
  56   81   93   73   53   -1   13   60   80   63   32    6 
  66   20   70   16   44   88   -1   42   11   90   30   51 
  36   87   67   40   20   49   76   -1   81   48   33   15 
  93    6   68   59   18    0   74    2   -1   59   92   22 
  29   60   19   69    2   82   11   32   33   -1   47   72 
  52   87   44    1   15   26    2   48   93   47   -1    6 
  61    6   77   13   81   79   72   73   54   53   34   -1 
