15
  -1   17   67   93   42   21   18   25    3   62   98   96   78   97   44 
  99   -1   57   23   29   88   81   88   77    2   97   18   47   15   85 
   5   18   -1   55   22   85   48   64   58   18   42   62   80   40   58 
  11   90   54   -1   62   47   77   44   36   11   32   65   65   30   36 
  12   97   73   18   -1   67   28   92    5   28    9   63   46   51   77 
  79   43   87   90   33   -1   94   52   33   71   96   21   34   29   38 
  99   11   74   12   60   47   -1   82   27   27   26   32   55   35   96 
  54   38   25   33   82   13   75   -1   67    7   27   52   30   76   25 
  65   57   64   16   68   38   80   28   -1   38   62    7   65   89   40 
  73   76   88   27   67   13   12   49   78   -1   87   68   85   66   73 
  68   42   98   85   99   62    1   19    1   82   -1   99   91   96    7 
  56   37   47   29   14   35    8   81    0   20   82   -1   79    7    2 
  16   74   75   84   68   26   69   68   88   23   39   41   -1    5   39 
  84   53   46   41   91   45   22    5   32   31   38   32   51   -1   72 
  63   11   74   80   85    2   64   53   28   86   73   68    9   65   -1 
