19
  -1   47    5   93    7    3   38   66   36    5   60   48   37   54   65   96   99    8   80 
  99   -1    0   28   10   98   80   40   94   88   30   97   19   79   44   76   24    3   32 
  62   22   -1   68   20   82   16    9   88   34    6   88   42   38   39   42   19   50   92 
  99   42   38   -1   39   72   36   10   51   32   86   28   36   18   90   58   38   62   92 
  55   72   80   41   -1   30   68   83   68   60   77   39   10   21   90    4   59   29   77 
  95   39   80   28   78   -1    8   16   48   51   26   87   13   18   94   37   98   35   67 
  19   70   88   79   47   27   -1   41   20   18   45   79   99   74   27   91   55    7   69 
  15   23   69   66   49   56   32   -1   19   50   69   17   85   37   88   55   25   19   54 
   4   60   74   74   58    6   74   84   -1   33   17   39   40   86    7   15   55   73   16 
  64    5   35   14   75    4   52   64   93   -1   59   41   64   14   45   77   40   72   35 
  46   46   19   31   63   11   71    1   18   86   -1    8   43    2   72   49   89   39   76 
  94   91   92   39   50   33    3   16   30   80    9   -1    2   67   55    0   39   39   15 
   2   10   16   20   49   77   15    3    1   64   93   40   -1   92   87   83   84   78   86 
  69   81   54    0   14   63    2   33   71    3   72   10   70   -1   74   72   87   46   21 
  16   62   77   17   78   70   10   71    9   45    7   87   83   77   -1   20   38   77   86 
  53   31   20   76   86   44   38   57   19   11   96   17   84   64   79   -1   61   33   58 
  83   95   81   92   41   40   31   76   17    4   14   46   90   20   30   62   -1   48   16 
   7   87   25   26   50   21   43   86   37   75    0   71   85   83   66   18   76   -1    7 
  58   59   36   28   63   50   26    6   22   56   68   23   25   75   62   50   53   12   -1 
