34
  -1   70    3   45   37   73   85   34   95   31   26    7   99   34   38   46   89   23   48   26   79   24   18   76    9   91   50   59   26   23   88   93   46   43 
  90   -1   83   17   75   70   64   58   48   23    9   83   62    7   24   37   56   50   16   80   20   44   89   64   95   48   90   70   88   35   68   31   25    4 
   0   53   -1   74   17   63   22   40   73   57   54   80   81   91   36   84   59   16   56    4   57   20   51   57   10   73   45   97   42   29   75   46   81   28 
  20   50   91   -1   94   43   16   52   97   97   33   41   33   69   52    2   26    8   59   46   59   17    9   33   14    6   75   95   81   21   29   61   93   79 
   5   87   22   21   -1   91   72   18   77   65    4   46   17    6   24   26   17   71   37   86   32   22   53   38   97    0   72   70   29   85   15   61   42    3 
  35   64   46   59   34   -1   23   24   90   70   94   48   94   72   66   17    9    4   49   32    9   40   81   10   64    4   91   49   19   52   92   74   40    8 
  73   99   94   96   24   85   -1   18   18   33   13   42   51   82    3   56   84   87   65   24   69   75   40   25   19   89   96   71   33   23   11   93   96   11 
  88   92   87   25   11   57   58   -1   76   99   10   58    2   18   42   90   83   18   11   11   58   88   30    0   84   53   85   59   17   31   55   80   19    0 
  67   96   11   76   54   39   75   16   -1   49   29   34   92   71   70   62   34   33   73   22   63   73   59   68   10   18   37   41   26   17   12   26   36    8 
  89   12   63   28   39   79   77   69   14   -1   21   92   36   84   27   69   57    1   84   82   60   52   92   31   90   34   57   59   46   35   96   55   24    8 
  70   52   48   49   29   69   15   51   61    3   -1   87   40   72   96   42   56   78   54   61   22   37   51   56   46   62   55   81   58   62    5   67   32   57 
  67   33   39   36    1   42   49    4   81   90   77   -1   77   84   85   55   38   46   29   28   49   86   74   12   93   56   70   55   13   37   87   23   56   72 
  62   92   73   56   42   78   37   32    7   14   16   92   -1   21    6   39   50   34   88   88   61    0   81   17   23   36   30   12   75   53   69   48   67   61 
  21   23   55   51   12   87   10   78   55   55   51   14   46   -1   54    0   34   42   61   87   76   30   10   64   13   22   40   18   91   88   38    5   61   61 
  60   65   26    0   27    4    7   82   56   73   28   10   74   15   -1    4   87   54   80   70   64   45   83   38   37   53   82   25   91   39   38    5   99   55 
  31   51   83   87   59   17   43   32   46    5   58   61   10   98   15   -1   42   68   31   87    3   21   24   56   55    1   48   94   92   53   46   99   36   49 
  34   23   60   52   67   45   50   24    3   63   86   53   78   29   21   61   -1   68   24   34   45   81   42   98   81   88   42   34   86   42   70   36   76   93 
  96   80   12   93   30   89   97   93   75   50   23    4   24   36   25   48   71   -1   70   81   65   20   62   53   63   48   40   57   18   76   85   64   24   66 
  28   18   48   17   67   42   93   69   17   49   93   54   74   94   77   96   27   42   -1   17   90   95   32   38   87   89    9   15   74   73   40   92    1   10 
  41   19   77   83   64   98    0   13   44    6   88   38   83   84   17   77   53    7   25   -1   85   98   12   74    7   28    1   80   20   93   33   82   34    4 
  59   69   68    9   22   82   53   28   22   43   64   58   61   93   12   20   18   49   18   83   -1   76   25   63   77   57   83   70   43   65    5   47   76   26 
  16   37   48   50   91   77   72   86   93   30   99   86   94   20    5   44   90   40   20   16    3   -1   97   25   86   19   68    3   76   16   31    3   84   68 
   3   34   11   80   58   50   25   88    1   12   83   21   69   79   64    9   51   32   64    0   57    2   -1   19   78    5   48   46   88   51   30    8   54   16 
  72   87   74   22   64   14   23   28   49   97   97   28   61   58   79   93   74   79    2   76   51   80   33   -1   99   26   21    2    8   30    8   76   54   47 
  50   76   12   17   51   40   66   48   90   95   61    0   26    6   75    6    9   51    9   41   37    8   20   58   -1   10   80   40   18   57   94   18   59   22 
  30   76   74   70   43   74   12   90   36   13   16   42   40   74    3   43   83   97   80   91   17   91   53   49   83   -1   24    6   30   42   18   52   72   94 
  78   94   89   53   59   79   41   72   96   35   64   22   39    7    6   88   40   49   57   31    3    6   14   79   13   44   -1   21   31   49   45   77   27   91 
  67   32   50   46   73   74   94    9   38   17    0   98   75   40   38   24   97   69   79    3   35   10   68   32   31   51   81   -1   28   29   60   20   96   93 
  70   94   18   45   41   79   35   58   31   33   85   71   71    9   68   40   41   24   28   51   92   60   35   44   41   63   73   53   -1   35   21   46    6   67 
  17    3    8   48   38   18   80   24    3    3   95   65   24   88    6   48   16    9   40   76   96   36   69   12    9   22   47   82   21   -1    5   50   90   60 
  10   38   51   29   18   75   32   74   70   97   98   10   55   46   26   65   86   54   13   23   23   25   84   98   73   19   19   30   21   61   -1   91   31   99 
  42   60   70   17   93   44   39   42   42   50   98   88   28   15   26   83   28    1   58    6   86   56   79   57   27    9   78   88    0   61   88   -1   94   22 
  10   11   67   54   51    9   96   53   59   84   81   74   62   64   55   64   75   61    2   31   92   11   11   53   89   51    6   50   91    0   24    1   -1   12 
  43   55   15   53   51   68   64   87   49   91    2   66   46   66   41   59   20   24   51   31   35    4   72   39   62   22   30   63   99   32   27   42   87   -1 
