11
  -1    6   51   88   77   33   57    0   91   87   97 
  58   -1   77   19   15   77   43   45   88    6   53 
  27   21   -1   37   15   99   68   81   61   42   26 
  24   48   78   -1   12   77   63   21   30   54    8 
  27   12   37   46   -1   80   14   89   25   54   47 
  30   81   68   19   96   -1   20   87   30   33   81 
  56   57   82   86   21   59   -1   50   42   89    4 
  50   16   69   88   14    1    2   -1    3   78    9 
   2   61   90   71   80   87   43   20   -1   17   76 
  53   25   86   35   12    7   47   14    2   -1   88 
  70   52   57   91   92   71   92   47   27   71   -1 
