8
  -1   74   51   93   16   75   41   97 
  71   -1   40   94   94   37   49   86 
  43   98   -1   71   77   74   37   43 
   1    2    9   -1   63   76   41   51 
  99   22   92   73   -1   25   85   41 
  53   78   38   76   71   -1   84   71 
   8   34    9   51   84   32   -1   81 
  10   69   24   11   71   85   26   -1 
