25
  -1   63   94   73   30   97   33    8   36   10   53   33   44   98   84   85   66   35   98    2   83   91   94   16   18 
  15   -1   30   26   78   32   47   95   47   42   69   30   91   54   38   79   16   44   65   60   94   49   98   61   36 
  96   63   -1   71   39    9   87   58   24   18   36   55   50   35   50   98   29   71   28   21   78   18    0   94   14 
  65   55    9   -1   67    5   22    3   53   37   75   92   46   62    2   23   32   90   78   35   26   28   85   55   52 
  65   76   30   83   -1   29   24   50   46   31   59   13   88   33   17   41   70   44   86   68    6   88   91   91   79 
  69   26   57   50   11   -1   12   54   76   41   84   11   70   60   61   68   92   72   34   80    5   51   74   75   47 
  60   96   53    0   87   96   -1   31    9   22   88   11   33    1   65   61   42    1   73   64   61   34   84    5   59 
  18   86   64   21   12   92   68   -1   72   88   74   24   27   70    8   36   93   96   47   78   49   64   40   43   65 
  13   59   27   99   44   32   58   62   -1   70   75   84   82   67   52    6   55   26   31   34   97   39   71   42   87 
  70   20   37   35   60   32    0   25   92   -1   79   77   36   12   87   98   34   62   34   17   29   39   23   36   65 
   6   71   14   45   94    8   33   16   29   22   -1   51   41   54    4   19   46   35   96   82   99   83   33   34   98 
  19   51   27   58   26   16   76   33   39   42   78   -1   33   51   63   49   32   85   53   73   92    9   44   38   44 
  92   73   44   76   58   30   74   77   81   53   36   59   -1   21   64   92   60    6   71   93   57   86   95   89   72 
   0   15   64    9   59   54    5   52   27    1   80   37   31   -1    6   15   64   11    3   24   33   19   16   93   25 
  39   39   83   78   86   24    2   86   39   66   47   51   72    4   -1   55   52   58   87   89   41   93   56    6   56 
  11   82   89   30   50   35    8   42   74   43   20   12   67   22   98   -1   59   40   97   62   12   53   69   16   11 
  56   58   53   49   14   59    5   78   93   47   60   43   82   68   85    8   -1   63   57   20   83   79   70   94   19 
  19   56   84   72   25    0   84   81   58   37   82   25   48   39   55   93   38   -1   15   36   20   36   74   80   51 
  83   52   34   63   74   28   34   93   36   70   18   61   71    2   94   81   91   28   -1   58   91   68   13   84    6 
  81   72   79   69   98   11   20   82   16    7   97   90   35   83   36   72   54   54   85   -1   77    8   32   58   51 
  60   69   42   80   34   78   87   67    2   18   36    1   81    9   35   97   16   84   40    3   -1   67   76   27   21 
  82   13   98   90   97    9   41   57   30   35   38   64   13   77   32   15   47   20   68   28   29   -1   55   26   97 
  91   66    1   59   94   28   32   76   93   31   18   90   92   59    0   22   46   38   38   59   15   70   -1   26   62 
  91   47   42   20   54   20   70   46   38   71   57   32   51   89   60   97   72   78   39   64   89   39   38   -1   35 
  29   77   46   96   99   73   10   90   72   53   63   26   25   33   24   64   56   81   96   59   23    9    8   95   -1 
