9
  -1   48   26   77   47    0   70   72   78 
  55   -1   66   83   86    4   59   57   41 
  82   65   -1   27   91   69   11   23   50 
  73   92   26   -1   84   16   11   62   16 
  89   40   15   42   -1   10   87   72   17 
   5   55    3   10   14   -1   12    3   49 
  78   30   40   47   41   16   -1   49   14 
  60   75   50   76   38   12   44   -1   27 
   4   59   69   66   99   93   84    4   -1 
