17
  -1   89   32    3   59   20   17   58   82   46   73   64    7   75   36   16   46 
  94   -1   20   73    6   74   50   50   80   27   99   81   33   44   36   54   85 
  68    9   -1   44   89   26   54   23   72   27   87   80    3   75   48    1   21 
  69   74   79   -1   95   76   29   28    3   28    9   88   25   46   94   10   66 
   3   55   55   29   -1    9   30   54   89   69   34   92   44   34   93   17   55 
  19   96   51   95   26   -1   79   50    6   40   91   31   38   85   42    5   89 
  49   12   70   58   43   24   -1   47   12   10   91    9   45   36   26   52   55 
  23    3    2    1   34    5    7   -1   75   96   39   65   33   81   70   22   82 
  83   45   40   78   69   40   42   32   -1   83    3   77   20   30   81   27    5 
  85   30    6   71   35   13   46   83   52   -1   12   16   85   34   91   67   69 
  36   60   99   57   52   42   89   35   97   18   -1   55   27    0   35   84   37 
  65   90   60   52    4    7   87    8   71   55   94   -1   57   46   13   27   34 
  73   26   44   25   20   33   61   18    4   68   97   56   -1    3   82   45   20 
  72    5   24   28   64   11   37   35   67   83   93   65   96   -1   72   52   70 
  50   96   47   71   81   60   41   37   29   90   93   84   24   38   -1   57   97 
  96   81   77   60   45   66   48   64   49   93   29   46   65   33   68   -1   15 
  29   15   38   63   76   31    0   57   22   94   93   46   84   50   95   80   -1 
