23
  -1   82   14   44   82   52    5   43   85   20   73   69   26   96   17   75   90   84   75   76   96   19   51 
  10   -1   23   43   42   92   36   66   85    9   48   99    6   83   51   11   26   36   83   51   57    9   99 
  27   84   -1   89   11   11   17    7   30   20   69    5   16   12   50   52   30   35   14   79   34   20   14 
  37   83   40   -1   26   66   43   83   27   42   62   63   84   74   74   53   33   56   26    3   14   42   67 
  64   94   97   99   -1    8   28   85   80   42   22   63   34   48   81   29   84   60   24   46   23   60   72 
  49   65    6    6   91   -1   61   20   85   80   84   32   29   35   92   58   20   73   52   94   88   39   95 
  22   68   31   82   92   77   -1    6   52    2    7   18    8   13   61   21   85   47   53   21   79   82    8 
  71   92   28   96   45   75   85   -1   36   70    7    4    1   41   49   30   99   53   32    7   23   92   72 
  85   65   58   32   18   31   63    1   -1   40   34   45   20   31   90   95   68   78   17   27   83   70   68 
  32   53   68   37   37   75   61   82   47   -1   46   47   57   30   66   89   93   19   81   79   16    1   62 
   7   49   30   85   18   57   20   41   78    4   -1   94   46   42   31   73    3   13   20    1   13   30   31 
  31   71   76    2   52    7   18    5   70   77   54   -1    0   15   25   10   35   66   88   92   12   86   34 
  43   59   89    9   31   90   22   61   73    5   32    1   -1    7   36    8   25   42   78    3   48   31   18 
  73   93   53   91   33   97    3   19   31   99   30   72   60   -1   61   14   34   75   87   39   59   40   46 
  48    1   71   90   31   26   90   62   44   64    7   50    7   40   -1   47   11   11   31   10   41    3   70 
  55   18    4   82   57   95   93   98   41   41   51   64   83   82   91   -1   74   97   35   38    4   37   97 
  97   85    8    8   68   70    2   71   92   57   89   96   91   99   91   84   -1   49   84   26    0   49   61 
  82   92   35   79   79   25   36   17   23   33   54   31   41   22    2   43   45   -1   46   52   35   43   43 
  86   86   80   35   23    6   35   72   67   17   64   55   49   43   80   85   12    3   -1   70   66   87   63 
  40   41   59   86   87   11   73   82    7   59   21   87   94   44   45   81   68   64   50   -1   32   19   99 
  27   52   36   92   55   58   10   94   22   51   35   81   89   23   44   62   57    3   73   78   -1   90   19 
  22   87    0   90   52    2   74   23   54   54   75   90   46   83    1   56   77   23   59   13   56   -1   48 
  88    0   62   45   56   87   76   46    6   98   86   58   41   38   13   67   13   67   21   89    9   19   -1 
