13
  -1   25   74   88    7   85   73   40   32   45   44   19   89 
  98   -1   87   67    0   35   60   47   94   73    6   71   87 
  87   50   -1   11   12   56   65   98   81   39   87   88   25 
  60   28   57   -1   57   25   29   98   23   16   66   75    3 
  78   22   49   52   -1   80   72   39   19   75   50   32   31 
  67   82   13    7   69   -1    1   84   81   82   93   90    7 
  74   89   82   42   55   57   -1   98   85   31   47   37   12 
  72   28   31   47   31   15   30   -1   98   98   43   57   19 
  97   41    1   79   87   43   38   61   -1   32   20    4   39 
  29    2   25   60    1   62   24   73   91   -1   56   72   74 
  71    3   72   21   46   30   41   43   23   94   -1   74   10 
  37   12   72   70   84   28    9   13   30   86   26   -1   83 
  49   50   57   92    6   29   66   30   32   90   51   31   -1 
