18
  -1   32   25   93   77   91   41   41   41   34   22   39   51   56    7   18   37   22 
  57   -1   52   50   40   53    7   14   99    1   13   35   51   60   16   35   85    9 
  64   77   -1    2   57   70   36   32    9   87   40   68   57   77   90   14   82   93 
   7   35    0   -1   21   86   53   34   21    5   95   37   92   32   98   57    9    0 
  66   31   88   98   -1   92   27   38   60   85   68    3   51   50   96   58   85   48 
  32   23    2   18   44   -1   59   13   34   51   46   84   60    7   37   27   91   25 
  25   83    5   64   96   90   -1   32   99   93   34   47    4   71   47   88   94   49 
   6   38   60   20   24   12   18   -1    9   24   77   46   51   68   23   29    4   28 
  45    0   70   29   51   64   63   98   -1   20   34   97    8   28   47   14   18    7 
  86   43   71    4   52   48   34   50   51   -1    2   73   80    6    2   77   58   72 
   6    9   88   69   59   60   55   57   68   35   -1   56   83    6   15   21   49   39 
  78   53   87   12    3   38   14   28   71   73   82   -1   48   31    7   55   41   95 
  76    0   56   84    9   76   19   65   11   25   81   33   -1   26   20   11   31   59 
  23   86   49   89   15   20   62   97   69   46    4   76   87   -1   52    4   39   60 
  88    1   88   60   66    0   37   99   85   64   71   48   47   82   -1   23   34   32 
  12    1   52   27   98   73   73   55   49   12   59    6    3   19   94   -1    4    7 
   6   23   59   44   74   44   60   98   92    7   80   67   93   12   80   94   -1   17 
  59   93   90   84    0   92   96   59   98   51   30   44   56   37   51   31   49   -1 
