7
  -1   31   51   99   48   83   56 
  14   -1   73   48   48   54   52 
  71   51   -1   41   24   48   29 
  44   99   97   -1   23   45   55 
  39    5   48   85   -1   82   24 
  14   65   27   65   66   -1   10 
  22   80   35   70   80   41   -1 
