35
  -1   42   47   91   62   12   78   11   55   32   29    1   98   22   12   70   47   15    1   34   71   73   73   34   48   56   97   47   88   24   41   75   18   89   18 
  80   -1   53   49   43    8   81   73   61   80   47   73    2   94   40    4   81   11   77    6   45   77   62   42   76   50   18   18   78   36   59   96   16   64   97 
  60   24   -1   79   85   85   11   32   10   13   79   50   17   60   61   47   18   59   24   81   53    1   83   72   71   13   60   30   62   29   46   59   89   70   38 
  26   55   49   -1   58   17   15   89   67   32    1   80   31   20   39    8   53   45    9   88   69   32   54   29   14   16   58   60   75   99   30   66   25   37   67 
  36   54   82   77   -1   73   67   79   53   98   51   45   58    4   42   19   44   11   51   98   40   65   14   51   25   42    2    7   60   28   44   79   16   50   62 
  93   23   81   72   29   -1   31   23   26   90   79   68    9   24   79   61   74   71   78   89   74   56   83   77   15   95   57   60   74   25   10   88   18   86   69 
  43   15    1   18   41   43   -1   50   61   52   26   92   65    0   15   96   41   42   52   24   19   67   71   76   79   46    1   42   34   71   28   56   66   95    9 
  85   88   52   35   49   56   61   -1   93   74   13    8   70   55   50   74   31   21   41    3   49   73    1    2   15   35   74   95   43   92   90   52   77   78    4 
  64   79   13   77   72   87   91   32   -1   57   98   35   31   29   56   24   32   58   49   33   60   64   21   86   11   64   79    1   69    8   31   25   25   62   38 
   2   86   25   45   71   34   43    6   17   -1   25   14   42    9   72   91   43   85    8   16   71   71   32   50   73    1   11   56   27   36   71   17   90   57   95 
  36   80   29   31   38   47    8   53   41   18   -1   77   84   13   62   44   29   86   16   13   88   41   67   99   49   94   35   20   63   26   30   58   14   62   40 
  97    1   39    6    6   32   24   83   16   89   98   -1   13   70   36   29   83   24   22   50   76   71   96   11   44   12   89   26   70    3   88   10   53   89    1 
  59   95   33   35   31   50   76   81   15   46   17   96   -1   81   93   18   32   69   41   80   33   37   92   22   63   15   78    4   77   31   45   79   42   93   12 
  29   76   14    5   57   29   51   26   25   32   71   95   16   -1   41   89   49   74   26   93   48   42    8   78   46   86   61   91   17    3   36   29   32   12   96 
  89   21   25   92   47    3   25   71   50   93   12   39   42   38   -1   66   88   38    8   96   17    6   34   78   49    3   34   86   33   18   50   81    8   72   58 
   0   71   13   77   42   64   71    6    3   65   96   21    5   35   81   -1    2    4   87   88   82   37   92   68   75   77   87   25   58   47   49   68   47   21   82 
  77   15   46    0   74    1   17   70   23   23    5    4   77    9   44   65   -1   44   33    9   12    8   38   51   85   48   98   35   17   46    8   99   23   75   45 
  75   49   98   92   20   73   15   77   30   92   39   74   58   83    7   19   47   -1   15   58   99   52    6   97   87   75   95   47   74   70   23   71   45   72   70 
  38   44   43   53   22   25   98   61   99    8   96    6   27   43   73   37   94   26   -1   96   44   65   71   91   13   46   62   36   69   59   60   91   49    5   87 
  55   27   12   53   40   12   61   36   70   40   31   96   78   26   74   74   22   91   45   -1   13    4   43   27   92   13   87    5   56   88   10   43   43   89   56 
  48   29   20    9   17   90   50   48   38   28   26   12   54   48    4   51   14   60   47   41   -1    5   12   80   10   68   69   20   12   64   61   68   13   90   88 
  74    7   30   24    7   69    4   34   33   10   34   89   62   48    2    9   42    7   21   22   17   -1   89   43   89   53   60   50   21   25   92   61   99   51   92 
  24   58   13   80   44   46   91   79   88    5   79   90   66   21   97   39   96   66   28   91   55   34   -1   51   57    7   76   49   69   28    0   13   52   10   26 
  84   55   24   27   86   12   84   65   54   50   39   51   89   35   69   70   78   76    4   30   33   11   58   -1   34   80   86   86   45   90   49   23   27    4   48 
  54   90   12   39    7   67   41   46   70   31   33   92    1   12   68   57   94   54   68    4   40    1   91   79   -1   46   33   28   70   60   32   70   67   74   82 
  58   33    1   51   32   24   82   65   16   35   29   36   92   75   42   61   80   83   14   23   62   60    8   90   82   -1   21   74   52   88    0   87   98   33   40 
  49   65   64   84   83   32   19   12   21   64   88   63   25   20   98   39   43   60   51    3    2   34   24   28   38   64   -1   28   25   62   14   66   64   79   82 
   0   14   67   19   27   88   83   67    3   60   39    2   51   34   14   55   37   17   41   62   45   79   26   26   57   41   40   -1   75   57   71    9   57   86   76 
  28   65   16   64   32   72   24   71   74   28    5   88   83   42    5   76   56    3   55   83   81   64   76   21   39   33   44   49   -1   90   30   77   18   95   46 
  82   79   18   59    2   92   39    7   32   74    2   90   50   10   93   57   93   26   22   21   47   13   54   91   14   96   74   92   15   -1   69   90   49   49   60 
  60    3   52   99   63   36   73   65   26   23   27   71   33   73   97   55   94   96   68   49   40   35   45   14   79   12   83   69   14   84   -1   29   74   88   33 
  74   51   69   99   68   48   75   47   19    8   20   17   15   15   65   35   16    5   70   13   19   49   26   55   70   92   39   99   66   79   84   -1   92   82   54 
  44    2   54   19   50   73   79   70   42   94   37    8   29   53   13   52   19   33    1   45   88   72   89   79   23   55   11    8    0   45   14   44   -1   48   68 
  15   50   93   94   72   36   88   10   96   69   15    9   21   34   94   75   31   34   47   20   66   22   28   77   82   28   22   48   24   22   16   39   72   -1   62 
  85   45   50   25    7   46   94   22   55   68   57    2   43   88   36   42   61    2   16   89   31   99   69    6   47   93   28   16   84   53   78   21   98   28   -1 
