27
  -1   67   19   53   63   92   80   93   44   18   89   37    5   44   27   78   24   88   22   90   79   62   74   50   12   19   78 
  30   -1    9   31   86   86   51    5   91   14   49   71   60   94   90    1   83   47   45   62   26   69   50    0   11   82   63 
  86   32   -1   27   57   63   57   67   46   43    5   97    0   96   64   50   20   24   96   62   25   79    9   22   41   87   92 
  43   40   55   -1   25   55   93   10   82   51   73   91   70   19   87   27   17   87   75   81   37   95   57   33   57   82   12 
  19   56    5   58   -1   48   49   50   56   74    5   49   84   87    0    9   31   22   29   18   49   98    5   25   31   95   72 
  88   80   82   22   45   -1   53   78   50   63   79   99   14   35   26   19   36   62   59   37   72   90   11   53   60   61   51 
  17   38   34   12   62   74   -1   93   96   48   90   49   78   40   13    9   92   27   96   18   98   33   80   57   22    4   99 
  33   57   11   46   60   29   36   -1   94   41   99   20   86   95   68   76   97   47   69   10   56   61   89    5   79   87   38 
  11   97   60   16   48   93   73   60   -1   40   34   89   76   80   82   27    1   69   75   21   97   72   68   66   34   77   27 
  23   34   58   10   72   70   59   32   86   -1    8   77   11   20   17   97    9   46   78   91   25   31   12    0   52   62   24 
  73   28   58    2    8   81   36   66   44    8   -1   36    3   92   74   63   69   38   83   39   35   44   37   65   88   62   96 
   0   15   49   14   39   74   43   50   76   51   31   -1   64   69   27   72   58   83   64   84   46   85   22   30   24   58   74 
  61   75   62   76   72   15   91   73   29   82   47   24   -1   32   75   27   16   39   97   95   63   55   78   79   39   25   64 
  14    7   41   24   33    2   99   48   30   71   15   73   96   -1   44   56   95   21   40   70   48    8    9   97    4   72    4 
  82    3   96   59   68   10   66    9   34   52   63   85    0   94   -1   57   15   67    5   11   75    1   32   68   71   33   28 
  33   30   32   57   35   67   61   83   26   81   93   45   90   79   97   -1   53   64   97   99   73   64   19   79   75   46   32 
  60   14    3   93   43   88   75   27   98   10   94   59   45   21   40   38   -1   18   82   69   15   87   34   64   87   59   28 
   6   90    3   52   22   63   19   78    8   14   66   84   41   64   46   88   75   -1   92   61   67   82   79   49   52   94   37 
  38   58   76   97   86   82   88   41   86   10   57   57   88   65   71    7   49   65   -1   23   96   53   99   88   14   18   70 
  45   68   74   39   57   12   97   33   62   35   15    2   28   53   64   85   63    5   51   -1   86   12    0   51   35   48   56 
  86   36   22    5   59   67   25   85    6   82   50   55   15   12   42   82   14   71   87   30   -1   56   50   35   59   37   47 
  12   40   35   60   97   73   49   71   78   60   39   55   45   97   37   95    5    4    7   99   86   -1   73   70   26    4   79 
  76   39   38   65   39   50    6   26   63   55   99   12   26   30   72   17   85   69   67   75   65   72   -1   79   24   23   18 
  50   94   44    6   25   20   97   15   38   36   18   96   62   81   51   14   93   29   44   17   99   29   86   -1   66    4    3 
  90   84   80   13   54   30   59   98   36   84   70   85    0    8   74   18    4   88   51    7    2   96   89   46   -1   65   88 
  28    3    6   32    7   48   68   87   61   22   69   73   72   57    9   43   42   61   51   16   79    8    5   82   67   -1   59 
  78   56    6   43   96   34   47    2   18    6   50   39   45   64   13   14   37   86   71   46   29   65    8   32   34   39   -1 
