33
  -1   76   25   64   30   84    4   95    2   88   48   58   69   25    0   79   16   97   79   76   93   35   72   97   76   30   92   33   27   99   20   95   27 
  45   -1   60    9   82   16    4   84    5   52   94   74   30   46    5   98   44   84   74   89   72   46   86    0   29   30   34    8   29   54    4    8   52 
  16   17   -1   34   32   21   70   37   25   65   64   55   63   69    6   59    6   80   48   30   79   34   30   60   64   16   68   45   23   24   53   75   40 
  70    9   25   -1   43   79   62   69   96   78   76   60    0   82   19   58   63   20   88   94   54   18   54   19   87   22   64   10   99   70   37   91   40 
  46   16   84   77   -1   31    5   26    9   81   86   61   16   57   19   31   77   59   25   84   30   79   55   17   53   71   27   52   41   16   44   82   62 
  12   18   91   43   23   -1   17    5   56   55   66   72   65   38   55   94   97   80   78   27   59   33   44   65    5   23   69   98   39   13   80   53   26 
  50   97   21   25   14   26   -1   82   22   93    6   39   83   62   33   80   94   64    8    6   49    4   71    6   28   40    5   19    6   37   73   84   88 
  70    5   65   36   32   99   10   -1   77   58   49   60   20   35   40   66   99    0   72    0    5   43    7   85   36   12    4   42   49   77   26   89   99 
  31   55   88   63    6   98   92   64   -1    0   52   36   35   45    3   86   45   75   86   50   71   45   87    7   57   92   49   59   21   27    0   73   58 
   7   61   74   14   59   66   30   11   19   -1   67   98   64   70   84   61   97   23   64   68   68   51   27   78   43   28   89   65   55   41   90   14    1 
  51   88   15   62    6   97   74   77   64   72   -1   41   86    9   55   36   32   19   56   52   70   84   82   14   12   71   31   68   65   21   34   66   24 
  74   33   86   80   30   12   58   95   85   51   33   -1   46    6   69   78   25   26   82   96   10   65   62   74   88   45   94   53   18   28   71   42   54 
   4   28   35   35   41   45   82   78   96   67   24   55   -1   37   54   80   63   88   28   25   53   42   51   94   87   46   99   57   26   71   99   81   75 
  80   68   62   73   13   44   51   61   12   27   16    1   33   -1   49   16   21   29   93   75   72   44   21   11   42   20   69   21   91   20    2   67    0 
  22   81   73   87   26   24   48   90    3   17   91   36   66   59   -1   58   47   52   85   19   48    6   83   91   26    4   12   70   24   66   37   25   40 
  70   50   27   96   27   75   38   30   92   81   67   10   40   77   58   -1   44   62   29   93   20   64   84   46   68   48   16   45   66    5   22    6   76 
  72   33   24   99    8   15   30   53   96   49   15   89   78   25   33   40   -1    7   26   60   71   62   58   92   10   27   89   28   84   11   34   12   35 
  67   89   35   28    4   17   33   52   66   48   93   44   26   27   36   33    5   -1   48   56   68   58   48   30   37   89   59   74    0   45   86   36   13 
  27   23   93   83   40   78   88   58   78   81   54    4    8   42   37   14   90   94   -1   34    0   94   16   38   36   75   12   36   73   50   24   38   30 
  99   31   13   39    9    1   49   87   83    3   44   43   97   81    9   39   27   43   40   -1   74   60   30   10   87   42   98   60   44   75   98   74   74 
  81   40   66   42   41   15   82   76   71   26   72   68    7   81    8   87   77   48   13   89   -1   78   23   76   72   73   89   68   48   39   43   23   73 
  83   89   15   76   56   97    5   27   23   77   96   83   10   56   22   87    4   35   76   34   10   -1    5   58   83   46   26   32   37   21    7   10   56 
  48   26   33    4   75   90   32   51   67   80   86   77   36    8   17   92   43   45   26    5   50   36   -1   88   48   62   20   86   84   79   96   40   27 
  74   25   32   50   67   16    1   86   48   39   64   84   47   33   76   42   78   54   47   81   42   35   29   -1    4    8   15   40   87   64   33   67   38 
  10   99   40   78   67   93   64   15   32   80   51   79   13   79   73   44   85   20   25   27    8   54   31   68   -1   22   24   55   86    9   74   24   19 
  73   65   49   92   10   14    7   43   46   10   74   12   89   48   56   74   20   81    1   28   87   85   96    9    9   -1    4   95   18   78   72   89    4 
  37   39   96   99    5   56   42   51   66   17   63   56   65   71   82   85   52   84   66   40   21   14   49   30   18   97   -1    0   49   69   41   53   58 
  80    1   57   85    9    0   89   28   69    4   36   86   76   18   23   80   54   89   20   75    4   22   57   74   71   57   75   -1   40   99   28   98   31 
  82    7   69   43   59   58   71   28   62    7   14   38   26   38   19   80   79   91   56   35   65   13   10   36   23   85   28   74   -1   66   78    5    0 
  86   74   43   45   84   15   26   47   74   92   37    0   82   56   33   62   48   41   97   65   54   59    2   29   97   30    3   15    9   -1   61   67   47 
  87   10   44   24   77   70   71   52   15    8    4   97   17   37   11   17   78   61   82   85   20   36   14   69   67   70   36   28   83    3   -1   27   22 
  14   71   46   43   94   69   95    9   78    0    6   95   89   18   12   68   79   46   53   51   83   19   73    2   41    9   82   24   13    9   99   -1   79 
  32   45   22   78   67   70   87   45   22   46   92   11   16   56   79   47    2   84   50   37    4   23   39   97   85   73   74   50   82   73   29   67   -1 
