31
  -1   72   59   44    3   23   50    4   45   96   37   18   31   72   10   60   67   71   91   74    9   64   67   75   40   24   48   84   77   37   61 
  40   -1   61   20   36   65   95   86   21   40   34   11   11   65   83   21   25    3   92   17   29   54   81   96   81   73   20   29   58   49   67 
  71   42   -1   28   91   78   45   39   17   67   79   51   78   42   17   13   15   94   16   60   63   45   14   97   94   95   70   66   25   80   16 
  44   51   58   -1   72   95   88   18   34    5   37   65    9   67    8   78   80   23   72   97   83   88   94   49   85   88   45   55   55   22   36 
  71   66   87   81   -1   90   82   69   60   68   27   97   34   36   64   94   66   45   69   38   94    5   26   88   54   63   29   51   19   84   73 
   7    7   91   46   40   -1   82   81   61   42   49   88   40   35   76   56   81   42   53   51   81   47    8   59   88   62   23   17   14   94   53 
  39    1   12   31   47   52   -1   13   28   65    7   30   54   99   65   30   56   47   73    9   50    6    9   58   17   97   20   92   14   86   86 
  19   78   39   31    9   39   35   -1   74   67    0   81   97    6   33   15   37   89   14   62   50   64   20   59   22   89    8   94   82   74   33 
  20   93   11   60   76   72   99   63   -1   46   18   64   79   68   22   12   83   59    1   97   73    4   13   45   15   87   35   24   33   69   98 
  66   89   92   29    1   20    1    0   84   -1   47   71    0   27   39   22   39   74   34   93   23   59   97   36    5   64   75   40   88    8   61 
  87   75   50   31   56   52   51   58    4   87   -1   57   75   87   36   66   62   28   40   96   21   15   55   70   51   12   34   26    4   75   87 
  65   62   62   16   45   70   20   96   28   76   36   -1   38    4   23   74   70   85    2   63   33   75   78   89   97   82   53   84   60   58   59 
  47   23   73    9   91   18   32   11   66   60   40    2   -1   98   44   78   25   14   15   27   29   49   55    8   90    4   90   43   88   50    1 
  99   50   77   24   59   20   42   91   84   61    4   24   15   -1   54   68   93   79   34   61   59   64   10   66   72   52   70   14   95   11   16 
  49   10   66   78   87   78   98   81   21   82   42   77    6   10   -1   32   74   55   63   61   16   22   25   26   40   49   30   11   63   78   22 
  31   27   84   98   57   71   28   55   53    1   90   47   79   96   57   -1   63   23   13   26   84   29    1    9    8   41   10   90   52   73   68 
  26   56   47   11   54    4   34   34   60   39   36   50   87   15   98   96   -1   30   73    9   56   57   91   57   18   51   51   28   93   55   53 
  62   82   10    9   45   16   14   31    3   26   71   39   28   58    6   26   54   -1   36   52   16   44   61   59    2   80   62    5   60   55   60 
  66   17   94   28   79   39   44   93   71   47   19   42   38   99   52   96   77   58   -1   32   29   26   29   91   37   83   23   99   88   35    7 
  48    1   76   43   29   55   34   26   48   57   25   19   99   64   18    3   12   48   14   -1   97   77   40   26   20   78    9   43   29   97   79 
  36   97   32   13   40   14   68   27   40   69   84   17   40   36   33   11   39   46   59   53   -1   43   36   46   69   57   24   30   52    5   27 
  83   42   24   16    7   17   82   27   96   74   96   80   91   89   16   77    0    8   23   59   13   -1   18   47   11   39    4   87   69    9   93 
  48   92   87   24   60   94   41   42   21   89   68   70   70   60   11   38   37   11   98   12   70   12   -1   30   17   75   21   74   63   90   83 
  56   38   27   43   62   88   89   56   82   62   45   51   32   67   63   95   58   52    6   56   64   28   20   -1   46   98   96   67   24   59    9 
  59   67   99   86   10   13   74   99   21    9   61   19   60   46   38   23   41   96   75    0   53   91   28   25   -1   89   78   21    8    2   32 
  17   61   99   68    0    9   33   26   60   55   35   74   26   47   20   64   70   13   61   97   13   66   88   94   91   -1   29   24   13   37   79 
  97    6   92   97   74   92   58    8   19   19   15    6   93   93   54   65   57   76   78   18   74   44   36   14   90   28   -1   44   14   93   81 
  93   90   88   38   87   14   30   46   74    1   17   41    8   10   34   14   75   92   90    5   62   64    1   99   31   91   79   -1   75   58   72 
   8    3   62   48   41    2   15   24   48   89   25   65   83   85   27   17   99   54   61   90   59   24    6   13   75   37   56   54   -1   64   14 
  26   25   70   40   25   63   42   40   87   42   82   65   59   65   50   38   34   50   92   96   92    4   20   98   17   47   88   73    1   -1    4 
  40   79   29   10   71   55   25   66   95   13   60   29   78   20   94   80   58   29   82   51   25   74    7   97   25   24   96   65   49   97   -1 
