32
  -1   69   89   28   99   51   51    6   77   17   53   90   78   83   20   50   29    0    8   10   83   11   87    9   18   84   34   94   80   51   44   29 
  21   -1   33    9   72   85   61   30   14   30   83   56    8   18   76   10   48   28   19   58   63   82   98   73   53   82   59   47   15   11   91   96 
  84   25   -1   58    8   62   71   38   76    1   73   32   62   92   60   72   92   88   91    2   52   26    0   77   79   35   36   26    2   99   18   98 
  83   95   56   -1   91    9   27   81   37   81   55   21   43   47   81   15   91   21   59   93   25   85   94    2   16   81   91   42   83   90   12   81 
  26   59   90   69   -1   20   69   51   57   50    6   30   45    5   11   61   96   85   72   89   10    9   35   65   25   16   56   19   99   98   32   33 
  24   43   75   94   64   -1   44   45   73   47    3    4   92    8   15    5   56   52   77   45   15   38   33   32   63    1   88   83    1   38   67   86 
  15   62   61    9   26    5   -1    6    0    4   61    4   97   69   71    2   25   76   32   22   91   70    7   23   86    9   63   21   62    1   40   48 
  68    2   61   77   81   18   35   -1   81   23   96   37   20   17    8   74   42   36   58   17   27   81   76    2   67   85   65   40   99   19   80   99 
  87   34   60   17   15   79   52   96   -1    2    1   85   74   18   94    0   13   30   59   30   10   92   58   12   11   44   30   51   43    1   83   43 
  40   17   55    9   33   34   14   81   88   -1   15   67   62   33   13   15   98   95   74   80   57   18   39   22   29   83   52   32   78    5   15   73 
  97   84   29    7   69   15   21    3    4   36   -1   70   18   21   35   33   20   82   59    0   40   77   39   14   58   74   18   90    5   23    5   30 
  20   42   11   27   11   27    0   14   83   36   36   -1   53   10   23   87   82    6   46   82   98   76   74   64   34    0   82   25   57   57   82   88 
  77   24   99   57   88   78   57    2   61   46   91   15   -1    8   14   54   90   72   52   24   22   28   98   86   15   51   20   40    8   77   74   96 
   7   99   96   64   39   26   73   41   88   71   84   55   79   -1   99    9   69   23   61   94   98   42   44   84   57   95   57   49   56   34   23   52 
  41   74    0   57   13   27   31    7   67   54   91   74   34   42   -1   35   55   18   48    1   16   90   46   52   99   93    9   48    1   44   24   54 
  37   50    6   95   64   85   78   23    4   32   66   78   18   61   65   -1   74   79   14   27   47   56   25   99   56   71   61   56   72   57   32   26 
  94   83   85   41   99   22   19   22   27   52   88   57   22    1   23   48   -1   80   37   76   79   93    1   31    1   72   92   10   45    1   42   23 
  95   77   60   37   76   83    8   98   10   12   39   67   35   92   90   83   73   -1   79   59    4   25   13   35   26   85   27   88   30   80   31    6 
  76    8   66   65   37   49   25   87   59   38   26   79   73   71   21    8   96    1   -1   20    0   26   33   36    4   18   15   93    1   96   76   59 
  24   36   25   41   73   27   66   61   38   56   39   17   81   10   39   90    6   40   10   -1    7   18   43   43   22   13   10   15   66    6   91   25 
  82   28    3   23   53   30   42   14   68   98   54   86   80   64   77   22   71   17   32   30   -1   35   27   25    9   92   35   25   59   94   68   36 
  76   48   39    0    2   69   42   16   38   92   22   76   72   87   53   94   10   22   78   40    9   -1   57   65   18    2   52   95   13   46   16   49 
  23   16   41   23   18   10   17   87    0   61    9   28   34   48   81   80   10   55   11    2   64   20   -1   67   35   22   20   82   35   18   98   37 
  41   15   78   16   85   40   85   24   93   47   34   21   81   34   55   13   45   10   76   47   27   97   67   -1   14   71   39   96   59   57   47   96 
  99   14   26   67   99   66   53   24   59    0   10   81   33   96   88   98   41   98   75   41   77   72    8   91   -1   95   47   40   54   56   39   50 
   7   53   28   75    4   95   28   80    6   80   90   87   13   87   27   11   80   78   86   21   55   10   81   99    6   -1   80   91   12   37   30   15 
  44   83   43   19   87   38   99   68   45   79   10   84   44   49   12   56   30   90   94   51   97   57   85   96   15   65   -1   87   27    2   17   94 
  99   52   38   70   40   76   70   60   73    1   70   58   46   20   22   54    2   64    0    5   61    9   90   10   76   56   97   -1   56   58   67   50 
   9   19   88   80   11   17    2   23   90    3   94    0    1   66   22    7   68   86   60   25   48   69   16   58   98   72    7   54   -1   82   26    4 
  92   98   45   72    9   62   74   85   52   29   79   53   83   97   27   90   17   14   50   42   14   72   10   24   70   82   83   76   17   -1   10   32 
   9   60   77   33   21   39   59    6   44   88   37   97   71   34   24   14    3   90   64   98   56   88    8   32   10   91   16   86   60   78   -1   19 
  69   38   48   54   59   88   13   66   32   53   55   81   77   42   57   91   45    0    7   43   56   96   52   89   58   95   57   45   55   35   16   -1 
