28
  -1   40   91   74    8   50   52   16   56   48   13   42   95   15   61    1   18   52   98   82   65   12   71   51   35   69   32   52 
  29   -1   65   86   69   57   77   43   17   28   47   34   36   95   47   79   42   14   92   95   32   96   93   66   61    5   37   65 
  92   59   -1   97   45   88   62   31   57   20   61   52   89   89   52   23   77   47   22    8   90   37    0   85   21   96   79   40 
  10   36   77   -1   75   29   88   72   74   77   87   57   86   59   18   39   48   59   91   72   37   90   46   45   32   83   98   18 
  57   46   49   97   -1    8   85   26   83   66   15    8   40   92   95   98   78   54   16   69   54   28   12   78   65    3   25   62 
  87   60   60    5   17   -1   59    6   14   67   92   93    3   58    8   11   51   52   58    1   82   64   69   52   18   97   16   97 
  62   71   22   77   59   82   -1   89   64   52   48   23   18   68   15   11   71   25   71   34   28   23   92   29    6   56   99   10 
  26   96   26   23   11   50   97   -1   88    9   80   77   25   32   26   48   50   46   15   14   17   41   85   51   21   61   95   51 
  19   51   50   29   77   98    7   53   -1    9   57   50   49   18   30   27   44   14    5   92   17   51    8   31   20    1   16   23 
  74   29   18   25   48   21   27   29   50   -1   26   37    3   87   46   54   37   65   36   16    9    3   21   53   20   24   13    3 
  44   66   71   67   41    1   37   18   49   58   -1   46   79    8   24   68   12   63   66   18    0   83    6   68   44    9   89   98 
  81   13   63   36    9   30    8   76   23    9   13   -1   93   10   23   39   41   32   15   61   96   79   80   66   31   63   72    0 
   8   34   41    6   67   55   21    4   16    3   12   93   -1   26   73   58   20   35   34   11   29   66   79   42   14   10   22   80 
  41   86    4   93   94   90   87    0   58   94   73   62   10   -1   77   26   55    3   51   14   75   86   48   39   67   66   18   10 
  32   28   32   12   21   18   68   67   12   59   54   64   69   48   -1   38   31   58   15    9   14   70   60   80   98   98   80   37 
  66   98   55   76   30   35   60   94   56   79   62   75   43   73   29   -1    8   42   29   98   25   40   65   34    6   35   94   86 
  33   45   18   70   11   16   77   39   46   12   51   92   21   30   54   96   -1   26   80   78   86   22    7   84   48   47   49   34 
  53   36   81   91   22   26    9   44   89   77   22   80   75   86   31   67   59   -1   14   74    8   40   54   86   26   28   93   10 
  28   93   11   63   98   47   44   90   21   22   51   66   11   29   88   43    4   26   -1   74   72   86   88   98   94   28   52   32 
  54   32   25   16   61   70   79   24   69   79   20   11    0   94   62   66   57   43    6   -1    0   48   33   74   72   71   63   22 
  65   43   74   97   50   58   74   66   19   97   46   95   66   77   67   29   77   61   91   44   -1   18   87   50   18   35   83   45 
  59   54   60   81   71    3    7   20   53   65   47   72   37   44   70   32   62   47    0   91   24   -1   13   34   20   32   21   71 
   2    8    6   47   19   13   59    0   84   15   59   57   68   77    4   92   14   48   14   46   10   61   -1   98   53   38   12   87 
  58   96   61   81   98   69   40   98   89   53    9   41   89   24   53   98   45   30    2   37   96   50    4   -1   42   12   17   93 
  17   55   57   57   66   53   18   99    3   39   39   53   80   44   63   74   86   39   27   84   84    9   87   74   -1    5   89   78 
  99   54   95   44   71    3    1   28   69   54   98   20   10   38   12   63   70   56   78   44   42   18   23   27    2   -1   32   66 
  28   89   55    6   41   61    2   85   33   57   87   13   26   93   12   98    3    2   10   19   72   67   49   17   61   67   -1   92 
  40   22   77    6   50   66   14    9    7   75   63   45   60   20   32   74   98   77   38   96   33   40    7   52   64   26   53   -1 
