14
  -1   72   92   26   96   86    1    6   24   65   30   46   50   58 
   7   -1   15   40   94   41   24   95   92   33   39   50   14   57 
  80   99   -1   47   84   30   20   76    8   68   15    9   74   91 
  27   57   89   -1   77   67   96   44    8   42   86   84   37   30 
  17   76   80   83   -1   85   13   82   85   97   64    5   25   73 
  73   92   82   99   35   -1    9   56   24   38   24   73   83   84 
  15   21   20   53    3   89   -1   81   83   72   67   48   55    4 
  97   19    9   75   92   34   67   -1   27   85   55   88   94   79 
  79   70   52   14   54   68   87   26   -1   73   90   15    6   25 
  87   25   74   94   29   23   14   90   98   -1   58   24   18   37 
  62   73   26   56   52   57   26   57   71   32   -1   77   58   58 
  50    0   25    8   25   12   34   51    7   63   75   -1   73   54 
  73   83   30   91   21   92   16   99   48   21    8   26   -1   78 
  79   58    7   89   68    9   89   93   17   66   58   51   18   -1 
