29
  -1   33   87   73   26   28   95    3   86   97   21   52   58   29   28   21   26   40   41   10   14   39   87    4   36   20   96   95   24 
  61   -1   21   30   94    8    3   72   88   50   75   27   47   97   79   58   78    7   79   56   48   21   66   14   12   53   71   48   26 
  67   43   -1    2   28   16   32   75   25   87   47   65   37   75   92   37   24   72   95   54   31   74   10   79   47   76   46   60   81 
  17   60   59   -1   36    4   14   17   20   98   92   97   86   91   63   23   18    7   12   42   79    7   96   11   34    6   42   81   82 
  40   93   16   57   -1   54   75   94   10   89   11   82   88   55   32   74   98   95   49   17   54   62   11   34   21   60   97    7   66 
  39   89    1   80   34   -1   17   89   88   44   35   50   86   98   33   74   53   65    0    4   12   49   73   66   63   84   52   37   44 
  49   44   63   89   85   64   -1   21   20   33   10   60   29   46   11   15   44   96   41   50   61   41    6   25   43   79   43   58   63 
  96   95   60   97   40   23   86   -1   77   39   59   97   24   70   58   53   68   21   21   64   17   62   14   30    4   72    7   99   51 
  50   57   15   98    5   75   96   97   -1   50   34   74   89   94   72   13   16   82   18   36   55   39    0   24    2   67   54   58   39 
  13   57   91   63   66   58   14   71   85   -1   10   68   35   96   43   24   90   67   89   58    1   59   94   56   99   95   80   53   62 
  86   63   53   99   72   44   14   38    2   28   -1   62   87   38   82   74   35   25   50   77   44   39   88   45   51   82   53   50   29 
  85   55   43   23   18   97   22   42   41   89   80   -1   96   17   94   35    8   77   62   95   54   12   72   99    4   60   96   55   95 
  50   57   24   87   12   68   11   82   65   85   24   58   -1   74   56    6   92   51   94    0   80   56   47   34   68   19   33   72   32 
  30   27   79   32   36    3   71   48   23   82   82   88   68   -1   58   99   42   67   57   86   18   51   38   50    7   85   84   28   57 
  18    0   41    0   80   20   84   16   23   55   17   99   38   51   -1   39   58   10   38   52   77   96   39   47   99   77   97    7   15 
  81   87   72   51   87   13    3   19   33   87   88    8   95   57    7   -1   85    8   99   43   18   37   95   47   85   86   94   85   16 
  43   44   31   25   31    3   28   70   68   32   42   53   71   30   13   66   -1   87   73   51   47   72   94   66    9   42   13   47   80 
  60   84   96    3   28   27   80   11   82    9   81    2   41   75   55   12    5   -1   21   31   44   94   82   92   66   29   10   27   71 
  75   26   51   87   10    0   91   38   79   23    1   14   32   35   16   25   10   24   -1   90   68   45   21   64   39   55    8   57   84 
  70   36   55   46   63   59   85   73   59   76   64   90    0   65    4   84    0   73   10   -1   63   97   52   31   94   25   47   85   80 
  56   42   65   26   78   72   24   41   31   10   67   42   38   31   85   90   48   89   75   49   -1   62   37   64   11   41   47    5   66 
  94   90   46    2   84   11   29   15   84    5    8   67   67   75   62    6   58   47   96    7   36   -1   23    8   51   12   72   62   53 
  19   68   19   65   10   66   68   95   77   49   62   61   54   70   81   22   98   43   80   56   90   76   -1   63   26   52   71   77   64 
  43   92   18   14   12   37   80   22   55   48   69   33   97   31   46    3   54   27   25   52   70    5    8   -1   60   34   72   39   38 
  95   68    2   39   60   72    5   72   62   37   47   17   85   68   50   34    0   49   90    6   76   67   58   99   -1   25   18   59   59 
  42   50   49   38   19   51   29   31   76   34   56   38   72    3   55    9   71   58   96   23    7   86   81   35    5   -1   91   34   30 
  10   94   41   52   96   90   42   15   94   71   47   70   58   55    8   82   58   63   91   81   73   39   57   80   77   38   -1   68   83 
  30    2   65   40   48    7   44   45   97   39   60   43   10   59   13   20   14   21    2   24   37   46   58   62   85   15   95   -1   15 
  53   63   50   83   65   15   75   14   22   20   11   72   11   23   15   21   83   81   94   49   54   96   26   43   94   84    6   32   -1 
