20
  -1   24   49   50   61   76   50   32   61   34   99   79   62   58   89   21   94   17   37   97 
  44   -1   43   71    0   63   94   25   91   56   28   44   20   52   45   71   65   21   73   98 
  82    7   -1   49   13   21   59    3   95    6   72   84   55   68   27   78   21   42   73   46 
  33   81   26   -1   30   54   30   75   77   96   97   50   46   31   10   47   97   31    6   52 
  78   64   24   62   -1   19   93   41   98   14   84   23   12   17   56   39   47   10   69   75 
  39   17   24   90   63   -1   55    0   10    4   83   69   56   62   33   81   24    5   26   66 
  55   92   50   78    4   19   -1   86   95   19   97   17   94   36   86   18   78   50   25   78 
  60   30   14   81   38   76   15   -1   71    0   20   97   18   75   41   20    5   98   40   91 
  45   59   40   62    5   29   49   23   -1    7   51    0   38   63   82   52   45   21   80   12 
  92   32   32   42   51   59   83   71   16   -1   33   63   59   79   74    0   41   79   81   42 
  54   40   45   55   78    9   89   82   54   10   -1   14   66   55   47   50   49   50   61   84 
  21   29   18   37   88   97   11   40   90   91   21   -1   85   97   62   30   52   92   91   94 
  27   97   56   41   63   63   88   65   12   38   78   49   -1   12    7   19   49   48   68   12 
  88   58   55   10   95   53   24   78   57   68   69   51   95   -1   67    8   37   82   71   77 
   0   36   68   78   37   80   38   56   81   86   24   45   74   34   -1    1   36   30   54   12 
  60   11   81   29   15   76   96   75   65   31   46   43   31   34   63   -1   61   71   43   99 
  79   76   37    3   21   12   38   74    0   20   28   13   80   92   94   61   -1    7   22   10 
  82   88   41   80   83   24   67   46   85   38   41   37   70   69   74   73   90   -1   38   63 
  65   39   35   45    4   15   37   50   29   96   72   39   30   12   32   63   47   56   -1   30 
  93   41   20   86   30   90   55    5   64   46   43   79   63   34   15   60   38   82   50   -1 
