24
  -1   72   10   28   49   33   39   14   41   40   54   94    2   52   50   42   28   48    0   78   34   11   71   72 
  24   -1   39   38   91   12   27    0   32   51   63   12   52   48   51   67   90   91   73   84   46   25   34   88 
   5   82   -1   88   36   17   99    7   41   75   46   79   66   59   58   19   43    9   82   55   62   30    6   81 
  72   50    6   -1   56   96   32   42   84   89   25   24   25   94   76   33   87   51   31   19   70   42   77   89 
  37   39   23   92   -1   53    5   51   86   78    1   92   34   97   76   77   33   66   54    9   43    0   85   28 
  87   37   60   58    7   -1   54   36   48   92   27   23   36   80   28   87   66   58   88   10   93   37   87   22 
  22    5   28   32   48   28   -1   17   77   67    6   89   26   13   95   14   13   87   93   36   24   73   65   63 
  91   23    4   53   68   41   40   -1   42   64   45   22   96   46    2   65   75   22   72   16    0   37   11   14 
  51   51   59   39   27   84   56   90   -1   75   80   94   80    0   88   21   95   52   18   69    0   16   72   17 
  91   46   89   59   46   27   23   12   30   -1   74   71   69    1   55   26   43   82   58   38   62   10   26   35 
  57   30   54   27   82   22   51   99   66   97   -1   41   25   95   68   48    7   50   74   30   19   27   85   97 
  71   19   55   61   81   18   39   17   75   21   23   -1   54    3   97    5   54   63   54   95   41   49   15   89 
   8   65   16   38   37   43   75   34   14   94   42   75   -1   28   60   66   97   87   87   20   42   90   69   99 
  97   33   54   44   74   55   60   15   16   77   31   54   14   -1   75   82    1   41   76   43   69    4   55   35 
   1   42   23   73   36   65   43   36   62   28   90    7    2   97   -1   19   69   13   96    1   20   63   28    2 
  16   69   30   11   38   87   66   26   40   60   49   14   97   14    9   -1   33   29   37   75   88   91   24    7 
  12   90   55   13   10   70   93   64   86   15   46   97   53   33   63   31   -1   74   76   80   40   25   47    1 
  58   76   90   85   64   81    9   23   93   99   30   59   61    1    4   77   87   -1   19   24   85   73    9    0 
  56   83   28   37   75   53   84   76   63   12   66   48   28   99   10    3   45   61   -1   33   56   23   34   60 
   0   74   80   76   59    5   86   11   61   21   40   50   97   93   86   25   57   98   44   -1   57   78   95   67 
  81   92   29   67   48    4   53   61   56   27   41   33   38   98   71   50   11   92   42   62   -1   41   87   48 
  19   96   99   63   54   77   10   73   11    3   54   78    3   58   31   64   15   11   57    0   49   -1   55   71 
  51   19   15   45   81   57   33   81   28   81   32   91   87   10    1   61   73   56   67    3   60   26   -1   86 
  24   93   97   34   45   99   41   16   50   60   83   96   93   92   81   75   20   62    7   63    2   69   17   -1 
