30
  -1   99    1   47    4   16   97   88   81   12   63   47   87   35   58   59   46   82   26   20   17   59   14   18   14   62   96   57   57   80 
  63   -1   89   31   16   88   36   32   37   76   66   49   39   13   88   27   24   99   25   58   78   45   75   37   11   45   51   74   42    9 
  83   74   -1   24   24    6   41   64   94   73    1   70   39    2   61    5   91   40   29   90   66   39   68   11   66    6   75   11    9   49 
   5   18   84   -1   80   95    8   38   36   24   84   61   25   54   53   27   67   58   70   60   39   61   26   78   81   89   96   39   64    7 
  49   65   65   19   -1    1   45   14   61   83    2   85   67   64   10   73   17   90   92   27   60   52   18   73   30   48   55   20   44   46 
  36    3   47   54   68   -1   19   55   65   85   17   48   88    2   67    4   13   92   73    3   37    0   15   89   70   89   20   18   44   92 
  14   42   80   17   90   34   -1   38   61   90    3   46    7    4   34    9   23   38   74   16   63   29   53   63   45   94   85   34   66   55 
  30   10   69   24   91   39   66   -1   25   77   27   15   32   74   74   36   60   36   60   51   62   28   14   92   33   30   89   79   15   75 
  46   71   57   56   92   81   99   83   -1   48   25   12   27   92   45    1   67   33   14   55   45   65   17   73   31    9   58   61   50   38 
  29   25   36   52   82   44   44   16   44   -1   28   64   21   40   43   13   37   97   32   71   11   87   16   28    5   42   59   66   52   21 
  17   90    2   94   26   54   29   71   50   45   -1   67   30   61   88   23    4    1   12    1   86   83   12   73   52   40   78   46   52   97 
  98   25   66   41   27   60   67   33   41   90   35   -1   86   57   66   47   97   41    4   99   53    5   85   37   70   10   41   62   41   87 
  14   38   37   91    4   78   18   16   98    3   58   40   -1   39   96   50    5   96   47   46    0   98   51   57   35   40   27   46   81   42 
  87   20   56   77   10    0   33   88   18    1   86   22   59   -1   79   61    8   29   18    4   76   16    4   75   67   61   10    8   41    8 
  41   83   47   62   91   76   72   91    9   12   62   11   51   36   -1   22   30   49   82   59   67   86   87   35   90   62    2    4   25   62 
  45   33    4   80   33   18   71    9   42   15   19    6   77   82   57   -1   13   56   39   62   39   98   81   77   86   16   20    0   70   24 
  25   33   21   11   89   53   44   59   76    5   53   91   76   59   20   10   -1   17   33   67   56   47   58    7   28   35   45   96    7   45 
  67   83   23   52   56   34   93    9   30   52   86   87    5   29   64   64   50   -1   74   33   35   93   42   83   51   49   63   39   46   12 
  46   91   31   82   14   83   38    0   76   48   82   80   86   70   37   15   86   53   -1   65   60   87   53   54   81   36   57   30   51   48 
  76   15   47   19   46   29   86   29   67   38   57   67   73   89   53   95   26   69   81   -1   80   86   93   19   39   99    0   27   57   82 
  31   57   10   46   56   29   93   85   67   74    5    6   84   72   79   73   78   74   52   99   -1    7   32   85    0    3   77    0    3   56 
   9   37   39   66   47   86   23   28   31   60   96    5   17   54   89   42   33   15   20   59   67   -1   19   66   51   56   66   54   85   18 
   9   94   27   46   33   46   93   71   21   73    2   81   69   60   51   23    1   93    8   16   65   19   -1   35   84   85   86   92    4   92 
  30   22    1   24   50   47   57   96   92   29   69   66   83    2   87   43   53   63   45   46   71   13   11   -1   91   49   47   28   87   92 
  32   80   22   55   81   98   57   81   55    5   25   36   74   43   20   76   31   15   82   46   60   80   69   26   -1   44   60   75   43   41 
  62   35   25   94    9   80   28    7   89   61   15   46   86   51   20   82   23   49   13   39   83   11   51   63   80   -1   77    7   93    4 
  51   34   67   38   59   13    0   92   41    7   81    2   74   80   41   78    0   23    1    1   88   92   84   99   44    0   -1   79   73    7 
  72   78   10   58   97    1   18   10    1   62    4   60   95    6   35   75   99   13   28   74   66   29   14   59   66   13   55   -1   66   45 
  28   25   69    6   88   80    3   89   50   14   42   12   18    2   59   76   89   35   28    2   63    2   69   44   17   28   62   82   -1   83 
  28   79   63    6    1   70   94   81   73   35   83   39   77   95    9   31   54   38   21   41   66   75   56   20   44    1   89   24   63   -1 
