26
  -1   87    0   12   77   91    2   64   21   79   11   69   31   36   80   21    8   85   36   86   10   21   11   74   29   44 
  23   -1   41   67   32   49   63   71   49   75    0   41   29   65   14    9   76   83   92   12   15   13   72    0    2   58 
  11   23   -1   21   37    5   66   12   46   33   44   95   96   68   97   23   68   90   53   85    4   14   13   39    6   77 
  55   71   49   -1   55   25   60   18   49   81    8    6   47   20   52   81   17   47   29   85   96    5    5   86   10   91 
  42   76    4   82   -1   34   82   89   57   83   96   83   43   67   84   25   75   90   72   47   42    5   64   41   87    1 
  38   92    7   76   54   -1   98   19   30   54   53   16   88   42   73   72   38   56   15    5   40   40   32   30   65   80 
  24   70   96   66    9   98   -1   56    1   57   84    7   55   55   37   61    8   53   50    2   27   22   93   35   89   50 
  76   82   83   58   47   15   83   -1   69   11   49   79   61   57   32   18   41   40   25   97   29   87   57   35   89   60 
  14   11    5   49   52   55   77   34   -1   90   36   33    5   19   55   69   20   86   30   29   18    1   70   10   78   19 
  92   65   77   79    6   37   45   69   94   -1   94   22   49   24    8   40   60   42   45   31   97   66    3   83   49   32 
  53   50   54   16   28   74   60   46   51   39   -1   52   40   84   22   34   30   96   83   54    4   75   66   46   73   97 
  95   39   52   30   88   84   36   90   39   52   19   -1   13   12   17   16    3   69   56   87   43   90   17   91   25   24 
  96    1   90   94   74   40   90   65   44   72   54   29   -1    8   44   20   60   15   85   24   32    1   27   54    9   66 
  49   99   84   41   76   60   89   77   50   83    3   42   25   -1   69   87   98   75   68   58   71   40   19   87   25   95 
  71   78   23   77   87   41   79   38   25   72   14   37   61   44   -1   40   96   47   82   74   68   21   24   43   89   82 
  15   81   53   54    6   49   77   36   24    7   75   65   38   13   43   -1   10   28   80   23   72   20   71   71   55   97 
  40   76   21   83   18    4   50   99    9   56   58   58   86   46   34   45   -1   22   52   83   35   95   45   15   27   20 
  87    0   91   11   55   89   51   83   62   86   53   66   37    5   28   45   63   -1   86   83    9   73   28   83   25   11 
  19   20    8   34   99   28   74   99   20   85    6   61   88   90   23   74   43   42   -1   63    0   70   61   63    8   44 
  25   33   73    8   58   36   79   30   45   66   30   73   92   29   45   29   88   58   17   -1   78   34   43   73   76    7 
  74   98   68   89   58   64   66   92   37   27   50   26    6   81   71   72   63   96   16   44   -1   94   45   32   52   62 
  62   86    6   88   14   65   62   64   85    3   23   49   70   15   39   97   17   65   55   50   88   -1   28   13   36   44 
  10   30   42   42   35    4   57   73   62   45   40   79   59    4   64   62   27   66   84   94    5   33   -1   12   70   89 
  14   10   69   80   46   65   90   29    7   84   16   64   41   89   78   38   29   58   97   34   74   12   13   -1   40   48 
   8   97   82   72   19   23   86   29   92   66   28    9    8   57   69   93   73   85   86   14   63   77   44   73   -1   74 
  30    0   38   43   92   87    3   90   21   27    9   44   66   91   88   84   19   49   93   28   18   38   53    3   76   -1 
