22
  -1   95   45   19   93    5    1   85   80    3    3   93   26   50    4   24   56   65   40   46    6   81 
  86   -1   52   71   13   83   27   27    1   54   30   96   99    2   89    5    3   27   37   58   30   30 
  36   32   -1   86   60   40    3    0   38   62   34   76   14    5   90   49   32   69   50   38   52   98 
  38   54   88   -1   95    9   15   32   19   97   14   56   81   52   16   21    8   69   12   70    3   88 
  36   60   30   37   -1   44    0   40   83    4   38   21   10   26   16   71   93    0   90   42   66   46 
  23   18   15   45   78   -1   36   57    0   39   97   88   99   28   26   95   80   66   78   84    4   99 
  94   83   67   65   28   19   -1    7   71   85   54   94   56   21   91   34   57    0   87   48   98   75 
  99   78    1   94   58   19   73   -1   94   24   24   40   59   44   57   87   63   64   10    1   70    5 
  57   91   96   43   48   97   30   48   -1   47    6   47   25   59   94   35   79   67   29   55   43   69 
  66   87   26    5    3   90   16    4   61   -1   21   61    4   69   56    5   66   39   53   65   97   53 
  90   56   47   25   87   66   54   94    9   75   -1   60   49   53   66   52   96   82    8   57   55   21 
  13   24   77   18   43   16   24    8   13   77   51   -1   22   24   76   61   90   83   56   51   10   16 
   0   64   34    4   60   68   12   69   75   33   82   52   -1   63   53   95   79   77   55   45   54    6 
  19   78   35   80   20   70   36   71   80    5   24   44   39   -1   28   56   60   41   25   35   26   60 
  87   89   13   34   21   90   90   66   96   48   37   26   83   17   -1   46   53   54   17   34   59   41 
  30   50   22   87   62   15   12   98   41   24   37   83   37   24    4   -1   79   14   22   75   14   59 
   1   50   76   47    3   82   17   89   41   10   72   44   32   59    6   99   -1   23   56   41   48   46 
  24   37   70   80   17   36    2   44   50   13   46    0   89   45   56   24   14   -1   97   17   25   69 
  61    9   80   20    9   56   76    2   56   22   78   93   92   58   62   28   12    7   -1   31   25    5 
  31   66   50   87   90   65   37    8   42    6   21   51   87   41   12   43   18   66   99   -1   92   44 
  44   37    2    7   17   14   66   48   91   71   32   58   21   71    0   38    8    8   80   15   -1   30 
  84   54   71   48   49   41   15   48   86   59   44   23   14   51   40   80   69   41   72   40   73   -1 
