21
  -1   88   11   46   13    2   29   77   34   92   25   42   22   18   36   42   57   66   33   12   71 
  49   -1   10   67   80   73    1   95   86   92   30   36   32   41   34   45   96   63   75   82   55 
   0   25   -1   77   70   61   72   27   79   57   40   51   58   50   70   38   76   71   34   62   63 
  64   50   96   -1   57   84   93   53   48   68   36    3   20   13   33   91   74   57   18   53   14 
  10   56   72   61   -1   26   10   89   50   96    3   65   12   53   61   70   37    7   75   37   27 
  63   93   48   76   26   -1   39    2   35    9    8   49   20   64   73   33   43   35   74   93   32 
  77   58   44   82   72   14   -1   19   31   42    9   58    5    2   58   82   80   49   84   15   59 
  92   16   31    9   89   16   52   -1   24   90   97    8   19    7   53    1   31   19   72   62   61 
  81   73   67   35   83   49   15   33   -1   85   30   44   78   98   27   87   87   43   91   64   85 
  88   72    4   47   25   57   79   97   29   -1   93   58   63   18   77   98    2   78   14   35   64 
  96   31   42   47   58   81   34   53   72   50   -1   38   12   23   94   59    0   51   38   97   32 
  84    8   47    2   85   46    4   16   12   91   80   -1   60   22   74    7   32   55   94   85   79 
  44   23   91   19   69   50   72   72   41   21   57   25   -1   29    4   79   67    2   84   83   66 
  27   15   79   50   89   86   82   96   32   20   75   29   95   -1   66    0   65   68   72   37   61 
  94   94   38   75   51   18   42   53   54   77   20   81   92   99   -1   83   33   37   18   29   22 
  38    4   51   33   22    3   98   91   76   88   52   70   34   91   45   -1   85   61   40   39   15 
  69   11   96   14   10   80   47   99   50   29   21   88   33   24   21   56   -1   28   72   99   56 
  12   51   26   46   94   23   32   55   15   71   70   85   34   19   51   44   51   -1   98   95    1 
  27   17   89   13   93   62   21   73   86   20   29   98   23    7   97   18   83   29   -1   25   98 
  52   96   35   86   67   86   82   18   37   77   19   16   46   60   29   92   74    2   65   -1   61 
  22   47   11   46   54    8   16   89   89   41   88   93   37   75   31   56   14   65   74    3   -1 
