16
  -1   62   66    4   46   71    2   39   62   99   62   19   31   93    9   15 
  96   -1   81   79    7   56   11   44   10   27   50   90   13   75   10   74 
  40   24   -1   92   96   71   64   98   62   26   49   24   98   80   69    7 
  48   18   89   -1   79   77   97   90   74   59   17   24   49   31   51   59 
  57   44   36   50   -1   40    7   14   91   21   92   40   46   90   73   67 
  98   21   85   39    0   -1   15   36   90   89   95    7   65   96   90   16 
   7   48   12   43   50   53   -1    2   16   96   24   60   36   22   51    9 
  89    1   82   27   92   82   42   -1   28   24   31   75   84   96   71   74 
  64   30   74   77   74   76   82   76   -1   92   78   52   53   66   74   56 
  76   64    9   58   43    1   93   85   81   -1   17   68   56   53   16   79 
  28   32   61   54   61   35   31   95   64   75   -1   73   16   28   40   91 
  36   68    7   45   78    2   46   71   39   27   41   -1   59   35   94   75 
  66   74   59   28   81   21   15   12   16   31   87   42   -1   48   68   34 
  91    4    2   50   50   80   52   48    4   43   28   97    2   -1   15   43 
  29   82   18   88   62   99   61   77   63   30   61    2   72    9   -1   70 
  58   52   75   60    2   77   92    6   25   48   49   53   45    3   69   -1 
