10
  -1   48   39   66   15   52   69   64   82   99 
  56   -1   81   92   24   30   58   85   57   60 
  13   95   -1   73   58   22   29   69   44   96 
  68   37   32   -1   73   38   71   91   53   75 
  61   69   57   60   -1   77   90    5    2   20 
  63   87   77   24   52   -1   72   49   10   47 
  78   32   43   74    0   80   -1    6   25   70 
  30   17   23   57   78   44   67   -1   90   22 
  57   47   24   78   11   11    7   87   -1   15 
  32   36   78   31   66   10   74   93   62   -1 
