23
  -1   28   38   88   62   18   41   98   55   58   16   17    9   51   64   51   85   53    4   75   29    7   44 
  18   -1    8   21   52   15   83   30   33   51   59   71   39   21   90   33   72   45   91   88   14   52   91 
  79    3   -1   76   32    7    3   13   66   47   83   74   20   87   42   56   18   27    7   77   99   98   50 
  41   31   74   -1   86   74   14   52   26    5   31   30   81   15   37   37   81   56   36   64   82   57   52 
  76   13   70    4   -1   72   99   55   70    1   96   54   76   34   28   90   86    7   48   70   37   29   37 
  26   18   18   34   55   -1   83   17   12   87   45   25   57   49   97    8   56   19   61    4   25   89   90 
   6   80   77   13   80   99   -1   50    9   36   28   28    7   63   35   90   80   47   77   25   24   86   27 
  73   46   35   92    7   40   70   -1   97   30   76   29   59   89    9   10   91   70   99   19   50    6   34 
  85   48   14   84   25   92    8   63   -1   71   81    9   58   26   68   98   96   65   81   24   46   92   13 
   7   55   56   78   54   27   80   12   62   -1   66   60   28   50   37   72   11    0   95   92   61   54   70 
  29    4   66   47   85   90   93   30   55   53   -1   85   63   31   91   91   11    3    5   29   63   33   32 
   0   58   43   52   53   87   13    7   58   94   12   -1   76   41   49   19   87   31   74   40   68   90   23 
  59   33   86   62   38   68   77   23    0   29   81   95   -1   81   87   82   46   94   92   93   58   69   34 
  60   88   73   43   14   65   12   56   88   71   89   27   86   -1   27   95   15    3   95   97   36   90   30 
  23   24   77   70   17   70   80   38   56   40   78   82   36   92   -1   47   48   49   88   71   90   67    9 
  70   62   25   73    9   74    9   51    4   33   27   81   55   44    3   -1   35   34   12   28   12   94   64 
   5   93   12    6   33   35   96    0   45   18   62   22   91   23   96   53   -1   74    0   38    2   34   93 
  98   89   28   33    1   56   45   47   72    2   93   36   60   26   72    9   27   -1   69   27   41   43   19 
  17   91   24   43   43   62   97   29   55   96   19   35   81   72   92   78   20   16   -1   81   13   53   93 
  91   25    2   18   46   82   12   41   53   29   32   77   72   75   39   70   57   94   18   -1   76   29   51 
   0   73   29   72   90   62   37   95   56   29   72   10   99   18   92   11   59   45   92   43   -1   22   17 
  70   61   39   27    7   57   55   37    8   56   62   89   28    4   52   18   99    8   47   71   18   -1   98 
  41   63   62   52    8   54   95   31   23   66   44   62   45   52   71    1   41   31   57    3   21   37   -1 
