18
  -1    6   59   31   61   68   96   75   68   25   11   10   50   78    4   32    5   13 
  22   -1   64    7   86   92   10   69   51   11    2   20   92   33    1   50   44   32 
  63   12   -1   28   38   81    5    1   43   55   79   47   40   36   61   62    0   20 
   0   44   82   -1   69   48   94   24   68   38   57   69   88    2   53   51   66   82 
  41   99   39   95   -1   42   47   26   42   39   63   55    1   15   75    1   12   10 
  22   60    4   46   28   -1   94   56   49   34   10    2   37   76   36   30   28   76 
  25   22   75    4   64   14   -1   67   19   67   34   47   20   46   57   42   58   13 
  89   38    7   97   87   41    7   -1   42   30   35   78   60   63    6   38   86   81 
  42   50   95   61   22   62   95   69   -1   82   94   26   77   52   39   18   43   98 
  15   82   39   22   24   21   57    3   81   -1   21    9   19   59   43   61   61   38 
  22   83   53   70   52   87   64   78   64   68   -1   69   34   11   67   49   94   58 
  71   70   79   81   25   13   54   35   84   13   78   -1   46   26   68   20   10   73 
  42   62   61    6   93   77   27   14   12   90   34   61   -1   36   92   85    7   24 
  18   32   37   72   19   21   37   49   19   63   18   92   25   -1   91   86   88    4 
  45   33   82   72   47   94   62   81    7   99   26   44   58    2   -1   62   90   91 
  86   62   64   75   11   84   39   81   28   64   73   14    4   29   11   -1   89   11 
  83   89   57   98   22   17   49   48   61    7   50   76   49   41   62   11   -1    6 
  38   75   42   29   56   22   93   81   88   50   11    0   39   22   35   28   32   -1 
