7
  -1   16   75   26   73   25   62 
  90   -1   41   66   64   44   86 
  84   19   -1   78   96   85   44 
  11   51   90   -1    5   51   33 
  75   72   84   44   -1   37    9 
  69   53   84   48   78   -1   61 
  10   20    2   28   36   99   -1 
