28
  -1   70   72   29   27   78   30   70   12   66   42    2   70   63   10   77   57   51   11   55   93   90   31   36   96   53   29    3 
  86   -1   73   11    8   95   35   38   23   14   20   45   26   39   39   80    9    2   42   38   11   46   49   18   91   91   49   27 
  88   54   -1   56   43   41   82   54    1   77   90   91   52   56   12   49   82    3   88   14   64   42    9    2    5   55   51   23 
  46   43   72   -1   25   83   79   81   26   20   15   33   21   93   75   65   97   31   29   47   65   32   87   31   96   82   40   98 
  87   95   49   11   -1   93   44   35   18   79   66    0    6   86   15   91   60   60   66   25   10   97   54    9   14   38   48   45 
  34   30   86   32   70   -1   33   33   33   27   30   20   45    9   87   97   67   25   65   58   85   77   76   62   87   25   68   96 
  39    6   45   85   92   27   -1   23   24   97   56   10   82   83   40    3   81   49   90   78   17   15   95   27   53   73    4   67 
  60   29   88    9   69   94   54   -1    6   39   33   29   15   31   85   25   65   21   65   68   54   67   10   32   84   78   28   11 
  31    1   67   98   13   97   38   22   -1   66   85   28   24   24   62   53   39   93   90   65   10   63   82   79   17   49   41    2 
  85   19   82   49   50   35   16    1   48   -1   13   39   71   31   76   51   55    0   13   60   40   58   51   57   69   14   39   48 
  84   41   41   86   26   61   68   75   63    3   -1   92   16   51   57    8   74   89   84   26   96   85   91   57   77   50   60   34 
  19   26   25   19   10   66   60   96   45   21   64   -1   20   37   19   64   53   23   22   61   49   63   46   27   11   83   19   20 
  60   69   80   46   88    7   71   59   69   90   19   66   -1   35   93   82    7   30   54   24   83   77   98   97   78   13   43    6 
  24   78   25   45   38   46   77   84   86   36    7   45    6   -1   97   64   24   84    9   58   44   39   12   20   75   41   70   72 
  20   83   67   26   59   45    3   56   35   49   34   71   35   22   -1   78   80   80   28   96    4   64    6   15   60   97   79   80 
  72   21   50   96   41   85   63   19   45   60   74    1   95   23   87   -1   66   10   10   97   42   90   25   90   47   41   48   62 
   2   46   41   34   70   14   85   67    7   70   82   26   15   43   52   69   -1   90   75   56    9   37   66   58   31    9   83   22 
  56   76   70   70   78   16   63   13   87   78   50    6   85   72   88   64   40   -1   31   16    9   74   44   65   83   33   32   41 
  65   93   76   87   49    4   57   71   83   26   34   48   65   12   98   71   50   22   -1   59   14   62   43   82   71   17   78   37 
  52   12   21   45   77   14   73   64   15   77   73   86   12   99   20   60   16   85   10   -1   87   35   33   47    1   95   42   35 
  19   59   14   56   63   26   29    8    3   95   81   19   10   10   44   48   23   96   68   35   -1   12    5   46    0   92   31   99 
  93   78   41   81   97   52   95   53   15   21   34   23   76   29   56   47   39   66   91   39   41   -1   87   60   77   52   65   23 
   4   58    6    3    3   84   96   84   82   48   31   87   63    4   22   38   32   51   46   79   43   64   -1   23   82    6   62   42 
  83   14   60   58   18   70   64   73   73   48   69   10   30   69   93   18   84   98   92   74   30   43   20   -1   62   38   37   85 
  73   43   47   67   78   14   27   36   84   97   52   58   23   52   79   85   83    1   78   53   85   28   97   12   -1   59   40   32 
  21   31   21   58    4   64    5   23   94   71   51   82   56    0   34   66   75   87   45   12   22   98   43   27   84   -1   71   24 
  48   82   16   80    3   47   54   13    3   18   71   27   65   42   30   47   50   30   82   16   58   21   14   70   43   12   -1   13 
  22   48   37   46   96   19   62   29   75   62   83   88   65   53   59   44   18   54   74   66    4   57    0   21   15   21   87   -1 
