13
  -1   56   62   46   90   68   63   27   78   28   60   93   33 
  17   -1    8   75   46   50   75   94   26   63   80   58   31 
  30   57   -1   72   88   34   45   86   42   60   84   32   28 
   0   11   58   -1   28   71   52   14   88   12   89   86   62 
  64   80   40   79   -1   61   98   10   43    7   83   83   41 
  80   69   35   40   54   -1   19   21   54   82   79   34    5 
  83   48   45   95   38   32   -1    9   54   12   50   34   25 
  48   44   68   56   27    4   49   -1    8   73   85    0   79 
   4   21   85   39    1   20   44   84   -1   68   90   32   58 
  22   93   13   34   43   47   60   44   43   -1   80    0   71 
  84    1   31   10   86   31   89   43   53   27   -1   82    6 
  47   26   42   67   68   74   26   90   20   91   25   -1   63 
  90   37   59   33   69   11    4    6   13   87   68   51   -1 
