27
  -1   93   94   28   84   99    2   97   29    6   82   21   38   20   28    5   61    7   36   51   54   35   59   28    2   15   11 
  90   -1   84   52   26   50   98   72   30   34   72   32   83   53   90   65   74   29   85    2   34   98   61   22   50   67   58 
   9   48   -1   12   76   59    2   60   63   80   63   13   52   93   47   24   26   31   29   16   96    4   97   34   58   32   32 
  20    6   34   -1   87   64   43   87   28   72   46   30   32   62   62   95   27   15   89   75   91   67   58   21   35   54   25 
  33   40   83   17   -1   73   55   23    7   95   40    3   82   20   27   81   51   59   43   13    7   22   80   48   97   72   15 
  55   93    2   62   70   -1   87    2    5   56   27   61   32   87   56   24   42   38   44   69   19   95   80   14   61   87   37 
  41   35   86   65    2   94   -1   58   57   56   80   44   10   86   53   90   47   85   77    3    9   71   93   53   40   13    1 
  20   79   62    8   68   55   95   -1   55   21   98   49   31    7   57   12   51   19   98    4    9   97   41   38    0   50    9 
  45    4   49   58    5   22   90   19   -1   82   58   26   77   65   47   27   66   31   34   23   95   38   95   45   94    4   42 
  36   43   94   86    4   39   42   54   50   -1   99   28   40   18   10   50   97   39   16   44   67   82   27   53   58   22   91 
  53   67   86    9   61   74   52   55   60   57   -1   47   55   63   97   54   91   89   25   53   39   22   92    7   18   11   42 
  98   65    0   20   56    5   40   94   14   53   20   -1   67   61   81   76    8   88   91   57   94   34   98   71   87   89   93 
  31   97   64   43   39   62    8   91   34   16   96   26   -1   63   10   80   83   29   41   16   57    1    4   48   58   99   82 
  56   22   21   97   16   53   94   32   96   85   46   56   76   -1   32   72   72   11   87   35   43   71   64   36   87   22   37 
  44   22   47   95   57   55   17   78   52   85   83   99   69   79   -1   84   15   35   61    0   60   85   11   47   20   54   70 
  37   90   58   59   79   54   33   78   49   90   33   18   69   37    4   -1   52   36   73   84   21   41   71   34   41   83   71 
   4   31   44   10    1   81    0   11   92   31   17   25    9   18   16   94   -1   37   37   31   93   41   68   18   25   41   59 
  49   27   52   32   98    8   15   42   18   69   75   70   80   67    1   50   93   -1   62   68   61   56    5   98   88   50   91 
   8   69   69   49   80   18   28   85   50   26   93   18   21   12   87   96   34   19   -1   64   36   69    9   98   38   22   55 
  95   20   95   98   63    3   19   32    4   99   50   32   36   53   10   82   71   31   46   -1   10   80   80   29   96   16   99 
   5   67   89   79   74   36   99   69   34   14   24   53   47   28    5   49   12   41    2   22   -1   75   25    6   21   35   38 
   2   17   34   70   16   91   37   57   70   11   45   21   32   80   35   56   85   82   36   42   84   -1   48   36   86   23   11 
  64   81   33   51   19   87   68    5   57   36   96   95   93   18   58   91   39   43   71   26   51    8   -1   61   88    3   45 
  88   39   83   63   50   99   96   35   51   15   22   19   72   32    8   20   79   53   38   37   44   29   32   -1   15   56   84 
  76   69   24   79   14   64   70   49   80   72   49   76    8   52   44   82   71   16   14   31   37   93   85   27   -1   83   29 
  57   15   97   65   51   73   34   27    4    0   44   74   49   24   98   98   52    6    2   48   41   74   65   55   57   -1   54 
   1   42   33   84   72   90   51   69   55   55   94   41   34   98   41   78   24   91   54   22   41    7   81   44   55   22   -1 
