8
  -1   14   21   18   45   17    3   41 
  80   -1    6   31   37   57   64   65 
  82   48   -1   61   19    9   31   24 
  94   79    2   -1    7   41   74   10 
  22   10   61   36   -1   31   79   33 
   0   34   74   81   41   -1    6   18 
  98   22   35   32   23   97   -1   51 
  32   80   27   26   59   29   86   -1 
