33
  -1   94   55   19   18   98   90   54   17   45   46   60   48   17   32    4   62   17   93   29   19    5   81   86   55   31    2   20   92   78   75   25   25 
  82   -1   44   43   80   87   49   97   84   95    9   32   13   42   88   75   11   82   56   30   87   89   16   94   21   18   14   13   49   41   38   26   23 
  34   69   -1    3   73   71   53   57   66   62   89   31   56   78   58   67   12   15   98   99    4   14   93   77   85   59   90   86    1   28   12   76   15 
  33   80   88   -1   56   33   46   23   47   87    6    4   17   65   71   29   32   69   28   88   36   73   66   73   85   56   11   86   37   75   62   52    8 
  94   40   17   79   -1   38   40   27   26   98   83   43   63   54   25   95   76   53   84   64   79    2   89   64   58    0    2   47   75   64   51   35   11 
  92   52   42   82   44   -1   69   60   43    4   56   58   11   81    6   87   34   42    3   65   44   92   29   54   44   31    2   71   48   53   58   11   97 
  63   53   80    7   75   40   -1    2   79   96   13   90   29   19   29   16   61   84   81    5   28   63   59   72   94   13   43   94   67   54    5   64   17 
  11   96   76   86   89   79   65   -1   37   92    8   67   11   89   83   24   74   64   29    2   27   40   75   74   54   70   20   73   76   78   37   93   89 
  86   70   27   75    1   44   64   45   -1   52   31    8   94   14   32   68   31   13   70   10    5   97   36   59   20   57   32   48   87   22   42   28   60 
  12   55   35   65   99   99   10    4   83   -1   18   98   49   50   66   32   15   88   43   20   38   31   32   10   40   16   58   27   38   52   55   50   16 
  10   85   81   62   37   91   66   72   61   64   -1   21   63   82   54   78   22   49   99   12   80   31   22   21   99   33   48   90   85   56   40    2   66 
  26   83   28   15   27   46   87   88   10   60   52   -1   44   14   82   67   63   81   79   96   64   54   17   64   87   65   54   24   73   94   26   40   72 
  62   20   39   89   19   78   29   29   39   33   26   53   -1   16   93   69   49   24   65   14   30   34   30   17   51   36   42   25   82   20   17    7   82 
  89   46   23    8   25    5   90   64   38   16   69   54   61   -1   90    4   37    7   70   68   41   52   85   45   88   79   70   70    0   87   77   34   76 
  76   10   85   53   15   27   69   53   43   90   60    4   81   64   -1   41   40   86    9   34   38   47   79   26   78    1   48   30   88   78   65   16   54 
  75   53   59   42   80   28   95   75   18   55   31   51   71   25   92   -1   57   86   78   95   33   57   21   12   58   22   42   98    0   59   66    6   86 
  72   65   28   52   93   76   80   63   83   11   15   55   36   59   12   23   -1   37   60    8   94   33   72    4   55   67   54    7   26   20   13   65   92 
  30   93   97   75   21   29   39    5   40   54   60   29   13   24   52   50   84   -1   12   96   18   85   52   73   52    6   33   30   26   46   95   71   77 
  41   20   52   62   49   43   67   89   97   79   70   62    4   74   64   40   87   60   -1   58   72   12   84   76   70   17    6   49   15   54   20   44   95 
  40   49    9   41   92   77   82   42    8   53    4   12   27   69   53   66   81   63   90   -1   46   99   66   16   68   25   65   84   79   37   28   26   29 
  77   35   22   22   12    5   64   73   10   68   85   37   89   90   56   23    6   46   21    5   -1   65   89   74   42    7   10   21   44   38   47   26   68 
  34   48   90   47   53   54   20   63   74   57   53   16    0   61   91    6    7   12   63   24    1   -1   89   66    8   99   39    5   90   38   31   58   73 
  31    0   72   37    6   44    0   32   53    5    0   53   66   91   11   26    3   75    2   57   64   21   -1   65   16   60   22    6   51    5   16   24   37 
  68   48   74   26   92   26   58   45   84   59   51    2   50   62   28    6   89   83   63   54    4   80   22   -1   16   55   28   67   60   96   43   97   64 
  43   23   90   35   50    0   33   86   59   84   88   62   46   69   20   88   52   35   94    8   15   16   76   70   -1   96   96   83   92   39   32    8   83 
  56   98   70   58   50   55   44   10   39   32   24   38   53   44   26    5   79   20   65   46   88   42   69   84   38   -1   52   76   29   36   36   64   92 
  86   35    2   36   90   98   98   82   83   22   20   36   18   98   42   49   70    7   48   58    1   69   42   39   73   70   -1   69    9   58   33   54   44 
  20   56   80   11   55   79   45   38   53   65   74   24   15   68   73   85   28   73   95   29   42   89   69   15   11   90   77   -1   69   23   31   13   96 
  39   93    7   94   24    4   84   30   21   11   54   36   31   79   73   59   53   68   41   47   57   62   15   68   52   92   89   27   -1   23    2   23   62 
  47   82    9   24   86   45   54    7    8    8   95   40   87   68   51   92   88   92   40   97    6   55   17   10   47    6   90   22   60   -1   13   36    8 
  48   45   32   86   43   86   46   51   46   41   43   33   62   95   26   50   39   66   48   98   73   17    8   20   24   98   42   84   64   30   -1   44   12 
  76   76   50   71   14   96   74   60   38   18   94   52   65   72    2   56   90    2   54   63   20   63   83   96   61   77   80   25    7   25   89   -1   35 
  53   40   58   68   88   33   80   78    3   74   30   68   98   85   24   88   87   31   51   59   94   86   55    7   63   88   33   23   13   74   10   18   -1 
