14
  -1   19    9   46   24   36   80   30   83   59   72    3   27   99 
  81   -1   18   19   72   95   34   62   32   94   47   53    5    4 
  11   70   -1   91   79   22   62   89   68   86   25    1   16   61 
  60   41   64   -1   87   92   45    5   11   17    0   97   31   84 
  43   78   90    1   -1   82    1   71   74   81   45   36   70   14 
  75   47   67   43    8   -1   27   84   72   14   28   17   72   91 
  86   72   89   17    9   32   -1   48   99   85   30   52   57   56 
  33    2   45   55   68   72    3   -1   35   15   11   62   52   84 
  29   80   53    1   72   40   25   13   -1    9   34   97    9   85 
  83   92   38   92   48   23   46   45   79   -1   15   17   34    2 
  85   45   17   37   81   46   69   87   47   93   -1   79   24    6 
  40   59   56   50   96   39   42   86   83   42   10   -1   29   88 
  41   96   57   75   99   42   72   16   31    6   14    1   -1   45 
  13   94   24   37   53   16   48    9   66   45    0   60   31   -1 
