24
  -1   60   73   55   11   33   54   83    3   53   76   66   15   29   27   21   76   10   45   94   54   59   40    6 
  31   -1   41   99   62   50   55   35   87   15   60   95   26   45    1   61   49   54   38   67   21   19   94   95 
  95   56   -1   40   42   11   51   82   69   82   23   69   97   73   24   84   12   91   45   59   17   42   61   31 
  91   67   21   -1   11   41   40   57   36   87   14   28   29   77   79   11   46   14   86   67   63   11   43   47 
  24   34   44   35   -1    4   87   48   35   30   68   56   93    9   48    3   97   87   17   25   17   94   56   80 
  92   22   19   60   37   -1   30   55   37    6   90   81   42   94   20   42   81    3   10   89   96   19   37   99 
  68   24   68   45   93   14   -1    2   26   59   76   45   71   14   75   26   51   34   16   84   76   62   57   70 
  95   60   81   84    8   52   73   -1   60   21   98   28   66   43   95   20   69   54   49   14   25   63   42   51 
  66   76   20    2    4   34   59   74   -1   30   71   55   66   80    8   40   92   29   38   72   47   81   67   68 
   3   73   17   17   98   32   59    2   50   -1   35   74   52   91    8   12   66   90   83   21   57   15   81   97 
   7   10   87   80   10   20   99   30   23   73   -1   47   93   23   31    4   77   81   92   51   33   83   60   97 
  49    2   33   23   59   48    4    8    8   67   47   -1   88   77   68   39    7   43   12    6   88   88   89   93 
  65   70   85   17   55   20   29   53   70   31   86   93   -1   43   86   49   51   94   16   99   34   93   19   74 
   0   14   86   58    3   26   47   96   92   17   33    9   25   -1   53   90   30   75   21   16   20   64    2   70 
  16   49   86   67   83   32   86   57   84    0   96   43    3   22   -1   90   51   14   60   36   75   37   42   65 
  67   17   87   83   90    3   37   60   71   86   98   38   70   30   76   -1   27   15   29   75   10   32   98   52 
  36   12   12   24   88    1   66   53   68   36   92    3   26   96   93   38   -1   67   79   88   58    1   19   34 
  81   86   63   56   48   48   54    0   36   19   65   60    7   66   27   12   35   -1   63   57   90   89   53   83 
  79   72   63   67   30   16   38   17   49   24   80    6   72   80   12   25   16   31   -1   90   77   90   56   56 
  55   43   19   12   34   60   65   17   91   89   32   58   20    1   97   89   50   73   69   -1    8   98    2   21 
  23   18    4   65   47   95   21    3   50   17   74   62   51   34   79   20   25   68   53   36   -1   40   54   33 
  29   56   58   51   65    8   53   86   31   23   90   96   71   37   70   26   87   87    1    1   90   -1   35   32 
  10   13   53   15   49   93   21   34   75   78   44   78   43   53   83   81   36    6   23   85   29   61   -1   55 
  56    0   94   57   54   84   44   86   46   57   91   62   58   85   35   44   12   13   89   42    8   42   25   -1 
