34
  -1   66   69   86   55   54   67   33   57   93   64   77   92    1   53   80   88   84   84    0   78   70    7   38   86   95   23    9   60   97   71   79   64   92 
  17   -1   71   46   84    4   55   30   20   84   74   21   38    6   62   74   90   62    5   61   69   43   47   65   66    8   77   63   79   56   79   72   74   50 
  70   10   -1    7   26   92   27   62   66    1    0   73   63   75   15   77   32   76   98   75   23   15   41   83   93   56   63   49   88   35   75   90   57   38 
  97   35   30   -1   77   98   49   30   98   22   93   25   89   22    9   66   20   84   41   36   77   25   29   86   88   30   74   75    6   16   84   96   14   20 
  26   43   18   75   -1   73   68   49   18   46   39   92   55   57   12   92   98    0   69   75   29   55   15   12   81   42   70   98   27   66   64   47   44   59 
  17   72   84   85   73   -1   54   83   64   46   39   21   10   31   72   11   52   47   92   60   15    4   93   57   74   43   84   92    7   31   37   18   48   61 
   2   86   34    8   69   99   -1    6   60   72   17   43   44   80   96   44   72    8   59   29    1   16   55   45   53   48    4   36   37   75   37   98   77   23 
  32   38   44   83   44    5   56   -1   61   48   52   41   96   96   66    4    7   95   58   76   50   55   29   98   59   65   87   34    2   85   64   77   70    2 
  22   53   98   79   61   12   79   14   -1   53   76   62   71   32   22   66   42   98   17   97   79   67   57   44   55   43   99   92   59   76   62   13   50   68 
  12   29   81   24   61   95   29   37   10   -1    1   21   32   19   64   82   36   61   61   56   70   57   11   66   56   55   25   85   18   91   87   38   55   69 
  19   79   30   67   60   19   77   13   40   61   -1   33   56   43   21   70   56   77   92   13   40   58   22   96   36   59   66   79   46    4   34   67   75   13 
  97   42   25   68   71   39    9   84   72   17   79   -1   93   39   35   23   32    1   63   42   75   59   78   34   25   57   32   81   43    0   57    8   49   51 
  34   18   75   25   79   11   49   96   91   94   36   78   -1   17   68   31   81   62    6   40   41   92   18   50   25   99   94   25    8    2   74   12   88   92 
  39   13   71   50   62   20   93   57    8   72   74   76    3   -1    7   90   62   48   31   54   18   34   79   17   80   56   78   34   83   90   75   27   29   88 
  99   79    3   71   73   60   79   97   86    7   52   94   97   14   -1   94   81   21   64   67   52   81   47    9   11   33   44    1    8   71   30   49   70   62 
  52   93   87   64   72   36    2   31   88   48   29   55   94   10   28   -1   58   77   80   40   76   41   51    9   85    5   70   57   87   19   79    1   23   73 
  88   87   97   24   41   29   65   90   58   72   84   20    0   43   97   80   -1   35   25   22   38   34   59   43   56   16   31   75   96   32   50   21   73   89 
  18   49   31   47   66   21    5   38    5   77   38    0   74   71   35   99   45   -1   74   86    4   69   94   21   52   70   69   85   72   90   10   62    8   11 
  93    8   78   14   65   16   71   43    7   24   69   30   59   21   27   85    7   31   -1   55   53    4    7   75   25   44   48   15    6   10   76   18    3   84 
  96   69   49   64   92   44   23   16   14   53   28   35   80   13   94   64   20   47   20   -1   80   23   98   24   71   65   83   33   41    1   36   77   49   57 
  79   13   49   23   89   18   37   42   46   24   75   59   18   91   32   66   63   12   41   13   -1   88   12   79   71   97   72   24   33   50   73   42   81   39 
  91    4   28    9   94   22    7   18   49   67   37   92   51   55    8   63   96   21    3   60    0   -1   27   57   73   51   42   75   77   84   56   68   27   60 
  48   89    6   22   96   25   72   15   14   16   66   69   24   81   17   98   85   29   98   12   38   23   -1   15   32   98   44   68    6   12   47   19   60   36 
  25   83   85    2    7    0   16   75   19   37    0   52   54   50   89   35    0   53   73   24   69    5   74   -1   13   25   33   78   73   52   38    9   77   73 
  46   32   32   99   48    8   70   86    8   22   92   10   12   28   10   65   53   86   86   11   13   52   36   46   -1   30    9   98   20   71   27   46   69   59 
  78   68   60   86   38   46   46   61   38   56   25   18   67   42   72    5   29   83   18   81   19   64   63   81   14   -1   35    4   94   81   73   53   60   42 
  65   46   32   11   93   45    2   49   70   20   68   13   92   74   94   27   92   27   99    9   42   80   23   77   36   17   -1   59    9   23   19   51   88   65 
  36   52   10   81   54   12   52   26   32   17   19   58   63   98   51   90   97   12   32   29   87    9   65    5   20   75   80   -1   39   78   20   57   14   24 
  19   48   78   31    0    5   16   69   76   74   32   26   77   74   24   89   58    5   77   19   71   34   40   98   66   31   28   38   -1   40   43   63   60   91 
  41   43   43   98   59   64   26   86   48   53   63   22   29    5   32   34   34   51   57   68   43   55   86   75   84   24   15   79   87   -1   27   22   81   23 
  17   31   34   81   58   20   29   63   36    3   44   41   87   78   75   38   36   95   82   43   81    9   27    5   76   58   45   56   80   26   -1   79   49    9 
  13   30   19   86   11   82   22   66   26   63   53   57   90   44   45   85   78   88   18   87   68   75   15   78   20   71   59   98    2   60    8   -1   68   91 
  27   54   54   62   28   73   40   43   78   97   33   22   94   18    0   35   36   39   55   11    7   33   84   78   44   82   33    5   42    1   96   22   -1    7 
   2   84   35   75   24   78   54   74   63   28   20   81   81   55   69   20   10   32   27   44   16   58   88   51   91   93   45   44   41   67    3   96   51   -1 
